{
	"tileset": "Etiles",
	"grid": [[21,21,21,21,21,21,21,21,21,21,21,21,21,21,21,21,21,21,21,21,21,21,21,21,21,21,21,21,21,21,21,21,21,21,21,21,21,21,21,21,21,21,21,21,21,21,21,21,21,21,21,21,21,21,21,21,21,21,21,21,21,21,21,21,21,21,21,21,21,21,21,21,21,21,21,21,21,21,21,21,21,21,21,21,21,21,21,21,21,21,21,21,21,21,21,21,21,21,21,3],
			 [21,32,32,21,32,32,21,32,32,21,32,32,21,32,32,21,32,32,21,32,32,21,32,32,21,32,32,21,32,32,21,32,32,21,32,32,21,32,32,21,32,32,21,32,32,21,32,32,21,32,32,21,32,32,21,32,32,21,32,32,21,32,32,21,32,32,21,32,32,21,32,32,21,32,32,21,32,32,21,32,32,21,32,32,21,32,32,21,32,32,21,32,32,21,32,32,21,32,32,3],
			 [21,32,32,21,32,32,21,32,32,21,32,32,21,32,32,21,32,32,21,32,32,21,32,32,21,32,32,21,32,32,21,32,32,21,32,32,21,32,32,21,32,32,21,32,32,21,32,32,21,32,32,21,32,32,21,32,32,21,32,32,21,32,32,21,32,32,21,32,32,21,32,32,21,32,32,21,32,32,21,32,32,21,32,32,21,32,32,21,32,32,21,32,32,21,32,32,21,32,32,3],
			 [21,21,21,21,21,21,21,21,21,21,21,21,21,21,21,21,21,21,21,21,21,21,21,21,21,21,21,21,21,21,21,21,21,21,21,21,21,21,21,21,21,21,21,21,21,21,21,21,21,21,21,21,21,21,21,21,21,21,21,21,21,21,21,21,21,21,21,21,21,21,21,21,21,21,21,21,21,21,21,21,21,21,21,21,21,21,21,21,21,21,21,21,21,21,21,21,21,21,21,3],
			 [21,32,32,21,32,32,21,32,32,21,32,32,21,32,32,21,32,32,21,32,32,21,32,32,21,32,32,21,32,32,21,32,32,21,32,32,21,32,32,21,32,32,21,32,32,21,32,32,21,32,32,21,32,32,21,32,32,21,32,32,21,32,32,21,32,32,21,32,32,21,32,32,21,32,32,21,32,32,21,32,32,21,32,32,21,32,32,21,32,32,21,32,32,21,32,32,21,32,32,3],
			 [21,32,32,21,32,32,21,32,32,21,32,32,21,32,32,21,32,32,21,32,32,21,32,32,21,32,32,21,32,32,21,32,32,21,32,32,21,32,32,21,32,32,21,32,32,21,32,32,21,32,32,21,32,32,21,32,32,21,32,32,21,32,32,21,32,32,21,32,32,21,32,32,21,32,32,21,32,32,21,32,32,21,32,32,21,32,32,21,32,32,21,32,32,21,32,32,21,32,32,3],
			 [21,21,21,21,21,21,21,21,21,21,21,21,21,21,21,21,21,21,21,21,21,21,21,21,21,21,21,21,21,21,21,21,21,21,21,21,21,21,21,21,21,21,21,21,21,21,21,21,21,21,21,21,21,21,21,21,21,21,21,21,21,21,21,21,21,21,21,21,21,21,21,21,21,21,21,21,21,21,21,21,21,21,21,21,21,21,21,21,21,21,21,21,21,21,21,21,21,21,21,3],
			 [21,32,32,21,32,32,21,32,32,21,32,32,21,32,32,21,32,32,21,32,32,21,32,32,21,32,32,21,32,32,21,32,32,21,32,32,21,32,32,21,32,32,21,32,32,21,32,32,21,32,32,21,32,32,21,32,32,21,32,32,21,32,32,21,32,32,21,32,32,21,32,32,21,32,32,21,32,32,21,32,32,21,32,32,21,32,32,21,32,32,21,32,32,21,32,32,21,32,32,3],
			 [21,32,32,21,32,32,21,32,32,21,32,32,21,32,32,21,32,32,21,32,32,21,32,32,21,32,32,21,32,32,21,32,32,21,32,32,21,32,32,21,32,32,21,32,32,21,32,32,21,32,32,21,32,32,21,32,32,21,32,32,21,32,32,21,32,32,21,32,32,21,32,32,21,32,32,21,32,32,21,32,32,21,32,32,21,32,32,21,32,32,21,32,32,21,32,32,21,32,32,3],
			 [21,21,21,21,21,21,21,32,32,21,21,21,21,21,21,21,21,21,21,21,21,21,21,21,21,21,21,21,21,21,21,21,21,21,21,21,21,21,21,21,21,21,21,21,21,21,21,21,21,21,21,21,21,21,21,21,21,21,21,21,21,21,21,21,21,21,21,21,21,21,21,21,21,21,21,21,21,21,21,21,21,21,21,21,21,21,21,21,21,21,21,21,21,21,21,21,21,21,21,3],
			 [21,32,32,21,32,32,21,32,32,21,32,32,21,32,32,21,32,32,21,32,32,21,32,32,21,32,32,21,32,32,21,32,32,21,32,32,21,32,32,21,32,32,21,32,32,21,32,32,21,32,32,21,32,32,21,32,32,21,32,32,21,32,32,21,32,32,21,32,32,21,32,32,21,32,32,21,32,32,21,32,32,21,32,32,21,32,32,21,32,32,21,32,32,21,32,32,21,32,32,3],
			 [21,32,32,21,32,32,21,32,32,21,32,32,21,32,32,21,32,32,21,32,32,21,32,32,21,32,32,21,32,32,21,32,32,21,32,32,21,32,32,21,32,32,21,32,32,21,32,32,21,32,32,21,32,32,21,32,32,21,32,32,21,32,32,21,32,32,21,32,32,21,32,32,21,32,32,21,32,32,21,32,32,21,32,32,21,32,32,21,32,32,21,32,32,21,32,32,21,32,32,3],
			 [ 4, 4, 4, 4, 4,21,21,32,32,21,21,21,21,21,21,21,21,21,21,21,21,21,21,21,21,21,21,21,21,21,21,21,21,21,21,21,21,21,21,21,21,21,21,21,21,21,21,21,21,21,21,21,21,21,21,21,21,21,21,21,21,21,21,21,21,21,21,21,21,21,21,21,21,21,21,21,21,21,21,21,21,21,21,21,21,21,21,21,21,21,21,21,21,21,21,21,21,21,21,3],
			 [ 4,15,15,15, 4,21,21,32,32,21,32,32,21,32,32,21,32,32,21,32,32,21,32,32,21,32,32,21,32,32,21,32,32,21,32,32,21,32,32,21,32,32,21,32,32,21,32,32,21,32,32,21,32,32,21,32,32,21,32,32,21,32,32,21,32,32,21,32,32,21,32,32,21,32,32,21,32,32,21,32,32,21,32,32,21,32,32,21,32,32,21,32,32,21,32,32,21,32,32,3],
			 [ 4,15,15,15, 4,21,21,32,32,21,32,32,21,32,32,21,32,32,21,32,32,21,32,32,21,32,32,21,32,32,21,32,32,21,32,32,21,32,32,21,32,32,21,32,32,21,32,32,21,32,32,21,32,32,21,32,32,21,32,32,21,32,32,21,32,32,21,32,32,21,32,32,21,32,32,21,32,32,21,32,32,21,32,32,21,32,32,21,32,32,21,32,32,21,32,32,21,32,32,3],
			 [ 4,15,15,15, 4,21,21,32,32,21,21,21,21,21,21,21,21,21,21,21,21,21,21,21,21,21,21,21,21,21,21,21,21,21,21,21,21,21,21,21,21,21,21,21,21,21,21,21,21,21,21,21,21,21,21,21,21,21,21,21,21,21,21,21,21,21,21,21,21,21,21,21,21,21,21,21,21,21,21,21,21,21,21,21,21,21,21,21,21,21,21,21,21,21,21,21,21,21,21,3],
			 [ 4,15,15,15, 4,21,21,32,32,21,32,32,21,32,32,21,32,32,21,32,32,21,32,32,21,32,32,21,32,32,21,32,32,21,32,32,21,32,32,21,32,32,21,32,32,21,32,32,21,32,32,21,32,32,21,32,32,21,32,32,21,32,32,21,32,32,21,32,32,21,32,32,21,32,32,21,32,32,21,32,32,21,32,32,21,32,32,21,32,32,21,32,32,21,32,32,21,32,32,3],
			 [ 4,15,15,15, 4,21,21,32,32,21,32,32,21,32,32,21,32,32,21,32,32,21,32,32,21,32,32,21,32,32,21,32,32,21,32,32,21,32,32,21,32,32,21,32,32,21,32,32,21,32,32,21,32,32,21,32,32,21,32,32,21,32,32,21,32,32,21,32,32,21,32,32,21,32,32,21,32,32,21,32,32,21,32,32,21,32,32,21,32,32,21,32,32,21,32,32,21,32,32,3],
			 [ 4,15,15,13, 4,21,21,32,32,21,21,21,21,21,21,21,21,21,21,21,21,21,21,21,21,21,21,21,21,21,21,21,21,21,21,21,21,21,21,21,21,21,21,21,21,21,21,21,21,21,21,21,21,21,21,21,21,21,21,21,21,21,21,21,21,21,21,21,21,21,21,21,21,21,21,21,21,21,21,21,21,21,21,21,21,21,21,21,21,21,21,21,21,21,21,21,21,21,21,3],
			 [21,32,32,32,32,32,32,32,32,21,32,32,21,32,32,21,32,32,21,32,32,21,32,32,21,32,32,21,32,32,21,32,32,21,32,32,21,32,32,21,32,32,21,32,32,21,32,32,21,32,32,21,32,32,21,32,32,21,32,32,21,32,32,21,32,32,21,32,32,21,32,32,21,32,32,21,32,32,21,32,32,21,32,32,21,32,32,21,32,32,21,32,32,21,32,32,21,32,32,3],
			 [21,32,32,32,32,32,32,32,32,21,32,32,21,32,32,21,32,32,21,32,32,21,32,32,21,32,32,21,32,32,21,32,32,21,32,32,21,32,32,21,32,32,21,32,32,21,32,32,21,32,32,21,32,32,21,32,32,21,32,32,21,32,32,21,32,32,21,32,32,21,32,32,21,32,32,21,32,32,21,32,32,21,32,32,21,32,32,21,32,32,21,32,32,21,32,32,21,32,32,3],
			 [21,32,32,32,32,32,32,32,32,21,21,21,21,21,21,21,21,21,21,21,21,21,21,21,21,21,21,21,21,21,21,21,21,21,21,21,21,21,21,21,21,21,21,21,21,21,21,21,21,21,21,21,21,21,21,21,21,21,21,21,21,21,21,21,21,21,21,21,21,21,21,21,21,21,21,21,21,21,21,21,21,21,21,21,21,21,21,21,21,21,21,21,21,21,21,21,21,21,21,3],
			 [21,32,32,32,32,32,32,32,32,32,32,32,21,32,32,21,32,32,21,32,32,21,32,32,21,32,32,21,32,32,21,32,32,21,32,32,21,32,32,21,32,32,21,32,32,21,32,32,21,32,32,21,32,32,21,32,32,21,32,32,21,32,32,21,32,32,21,32,32,21,32,32,21,32,32,21,32,32,21,32,32,21,32,32,21,32,32,21,32,32,21,32,32,21,32,32,21,32,32,3],
			 [21,32,32,32,32,32,32,32,32,32,32,32,21,32,32,21,32,32,21,32,32,21,32,32,21,32,32,21,32,32,21,32,32,21,32,32,21,32,32,21,32,32,21,32,32,21,32,32,21,32,32,21,32,32,21,32,32,21,32,32,21,32,32,21,32,32,21,32,32,21,32,32,21,32,32,21,32,32,21,32,32,21,32,32,21,32,32,21,32,32,21,32,32,21,32,32,21,32,32,3],
			 [21,32,32,32,32,32,32,32,32,21,21,21,21,21,21,21,21,21,21,21,21,21,21,21,21,21,21,21,21,21,21,21,21,21,21,21,21,21,21,21,21,21,21,21,21,21,21,21,21,21,21,21,21,21,21,21,21,21,21,21,21,21,21,21,21,21,21,21,21,21,21,21,21,21,21,21,21,21,21,21,21,21,21,21,21,21,21,21,21,21,21,21,21,21,21,21,21,21,21,3],
			 [21,32,32,32,32,32,32,32,32,21,32,32,21,32,32,21,32,32,21,32,32,21,32,32,21,32,32,21,32,32,21,32,32,21,32,32,21,32,32,21,32,32,21,32,32,21,32,32,21,32,32,21,32,32,21,32,32,21,32,32,21,32,32,21,32,32,21,32,32,21,32,32,21,32,32,21,32,32,21,32,32,21,32,32,21,32,32,21,32,32,21,32,32,21,32,32,21,32,32,3],
			 [21,32,32,32,32,32,32,32,32,21,32,32,21,32,32,21,32,32,21,32,32,21,32,32,21,32,32,21,32,32,21,32,32,21,32,32,21,32,32,21,32,32,21,32,32,21,32,32,21,32,32,21,32,32,21,32,32,21,32,32,21,32,32,21,32,32,21,32,32,21,32,32,21,32,32,21,32,32,21,32,32,21,32,32,21,32,32,21,32,32,21,32,32,21,32,32,21,32,32,3],
			 [21,21,21,21,21,21,21,32,32,21,21,21,21,21,21,21,21,21,21,21,21,21,21,21,21,21,21,21,21,21,21,21,21,21,21,21,21,21,21,21,21,21,21,21,21,21,21,21,21,21,21,21,21,21,21,21,21,21,21,21,21,21,21,21,21,21,21,21,21,21,21,21,21,21,21,21,21,21,21,21,21,21,21,21,21,21,21,21,21,21,21,21,21,21,21,21,21,21,21,3],
			 [21,32,32,21,32,32,21,32,32,21,32,32,21,32,32,21,32,32,21,32,32,21,32,32,21,32,32,21,32,32,21,32,32,21,32,32,21,32,32,21,32,32,21,32,32,21,32,32,21,32,32,21,32,32,21,32,32,21,32,32,21,32,32,21,32,32,21,32,32,21,32,32,21,32,32,21,32,32,21,32,32,21,32,32,21,32,32,21,32,32,21,32,32,21,32,32,21,32,32,3],
			 [21,32,32,21,32,32,21,32,32,21,32,32,21,32,32,21,32,32,21,32,32,21,32,32,21,32,32,21,32,32,21,32,32,21,32,32,21,32,32,21,32,32,21,32,32,21,32,32,21,32,32,21,32,32,21,32,32,21,32,32,21,32,32,21,32,32,21,32,32,21,32,32,21,32,32,21,32,32,21,32,32,21,32,32,21,32,32,21,32,32,21,32,32,21,32,32,21,32,32,3],
			 [21,21,21,21,21,21,21,21,21,21,21,21,21,21,21,21,21,21,21,21,21,21,21,21,21,21,21,21,21,21,21,21,21,21,21,21,21,21,21,21,21,21,21,21,21,21,21,21,21,21,21,21,21,21,21,21,21,21,21,21,21,21,21,21,21,21,21,21,21,21,21,21,21,21,21,21,21,21,21,21,21,21,21,21,21,21,21,21,21,21,21,21,21,21,21,21,21,21,21,3],
			 [21,32,32,21,32,32,21,32,32,21,32,32,21,32,32,21,32,32,21,32,32,21,32,32,21,32,32,21,32,32,21,32,32,21,32,32,21,32,32,21,32,32,21,32,32,21,32,32,21,32,32,21,32,32,21,32,32,21,32,32,21,32,32,21,32,32,21,32,32,21,32,32,21,32,32,21,32,32,21,32,32,21,32,32,21,32,32,21,32,32,21,32,32,21,32,32,21,32,32,3],
			 [21,32,32,21,32,32,21,32,32,21,32,32,21,32,32,21,32,32,21,32,32,21,32,32,21,32,32,21,32,32,21,32,32,21,32,32,21,32,32,21,32,32,21,32,32,21,32,32,21,32,32,21,32,32,21,32,32,21,32,32,21,32,32,21,32,32,21,32,32,21,32,32,21,32,32,21,32,32,21,32,32,21,32,32,21,32,32,21,32,32,21,32,32,21,32,32,21,32,32,3],
			 [21,21,21,21,21,21,21,21,21,21,21,21,21,21,21,21,21,21,21,21,21,21,21,21,21,21,21,21,21,21,21,21,21,21,21,21,21,21,21,21,21,21,21,21,21,21,21,21,21,21,21,21,21,21,21,21,21,21,21,21,21,21,21,21,21,21,21,21,21,21,21,21,21,21,21,21,21,21,21,21,21,21,21,21,21,21,21,21,21,21,21,21,21,21,21,21,21,21,21,3],
			 [21,32,32,21,32,32,21,32,32,21,32,32,21,32,32,21,32,32,21,32,32,21,32,32,21,32,32,21,32,32,21,32,32,21,32,32,21,32,32,21,32,32,21,32,32,21,32,32,21,32,32,21,32,32,21,32,32,21,32,32,21,32,32,21,32,32,21,32,32,21,32,32,21,32,32,21,32,32,21,32,32,21,32,32,21,32,32,21,32,32,21,32,32,21,32,32,21,32,32,3],
			 [21,32,32,21,32,32,21,32,32,21,32,32,21,32,32,21,32,32,21,32,32,21,32,32,21,32,32,21,32,32,21,32,32,21,32,32,21,32,32,21,32,32,21,32,32,21,32,32,21,32,32,21,32,32,21,32,32,21,32,32,21,32,32,21,32,32,21,32,32,21,32,32,21,32,32,21,32,32,21,32,32,21,32,32,21,32,32,21,32,32,21,32,32,21,32,32,21,32,32,3],
			 [21,21,21,21,21,21,21,21,21,21,21,21,21,21,21,21,21,21,21,21,21,21,21,21,21,21,21,21,21,21,21,21,21,21,21,21,21,21,21,21,21,21,21,21,21,21,21,21,21,21,21,21,21,21,21,21,21,21,21,21,21,21,21,21,21,21,21,21,21,21,21,21,21,21,21,21,21,21,21,21,21,21,21,21,21,21,21,21,21,21,21,21,21,21,21,21,21,21,21,3],
			 [21,32,32,21,32,32,21,32,32,21,32,32,21,32,32,21,32,32,21,32,32,21,32,32,21,32,32,21,32,32,21,32,32,21,32,32,21,32,32,21,32,32,21,32,32,21,32,32,21,32,32,21,32,32,21,32,32,21,32,32,21,32,32,21,32,32,21,32,32,21,32,32,21,32,32,21,32,32,21,32,32,21,32,32,21,32,32,21,32,32,21,32,32,21,32,32,21,32,32,3],
			 [21,32,32,21,32,32,21,32,32,21,32,32,21,32,32,21,32,32,21,32,32,21,32,32,21,32,32,21,32,32,21,32,32,21,32,32,21,32,32,21,32,32,21,32,32,21,32,32,21,32,32,21,32,32,21,32,32,21,32,32,21,32,32,21,32,32,21,32,32,21,32,32,21,32,32,21,32,32,21,32,32,21,32,32,21,32,32,21,32,32,21,32,32,21,32,32,21,32,32,3],
			 [21,21,21,21,21,21,21,21,21,21,21,21,21,21,21,21,21,21,21,21,21,21,21,21,21,21,21,21,21,21,21,21,21,21,21,21,21,21,21,21,21,21,21,21,21,21,21,21,21,21,21,21,21,21,21,21,21,21,21,21,21,21,21,21,21,21,21,21,21,21,21,21,21,21,21,21,21,21,21,21,21,21,21,21,21,21,21,21,21,21,21,21,21,21,21,21,21,21,21,3],
			 [21,32,32,21,32,32,21,32,32,21,32,32,21,32,32,21,32,32,21,32,32,21,32,32,21,32,32,21,32,32,21,32,32,21,32,32,21,32,32,21,32,32,21,32,32,21,32,32,21,32,32,21,32,32,21,32,32,21,32,32,21,32,32,21,32,32,21,32,32,21,32,32,21,32,32,21,32,32,21,32,32,21,32,32,21,32,32,21,32,32,21,32,32,21,32,32,21,32,32,3],
			 [21,32,32,21,32,32,21,32,32,21,32,32,21,32,32,21,32,32,21,32,32,21,32,32,21,32,32,21,32,32,21,32,32,21,32,32,21,32,32,21,32,32,21,32,32,21,32,32,21,32,32,21,32,32,21,32,32,21,32,32,21,32,32,21,32,32,21,32,32,21,32,32,21,32,32,21,32,32,21,32,32,21,32,32,21,32,32,21,32,32,21,32,32,21,32,32,21,32,32,3],
			 [21,21,21,21,21,21,21,21,21,21,21,21,21,21,21,21,21,21,21,21,21,21,21,21,21,21,21,21,21,21,21,21,21,21,21,21,21,21,21,21,21,21,21,21,21,21,21,21,21,21,21,21,21,21,21,21,21,21,21,21,21,21,21,21,21,21,21,21,21,21,21,21,21,21,21,21,21,21,21,21,21,21,21,21,21,21,21,21,21,21,21,21,21,21,21,21,21,21,21,3]
			 ],
	"adjacency": [null,null,null,null],
	"tileType": {"walk": [32, 42]},
	"entities":
	[
	  {"type": "Entity",
			"sprite": "bluekey",
			"position": {"x": 3, "y": 20},
			"dimensions": {"width": 1, "height": 1},
			"animation": [false, "none", true, true],
			"onUse": "function talk(user) {this.output.setMessage([\"'You find the great blue key:\",\"you pick it up and put it you pocket'\",\"Press the spacebar to continue...'\"]); PC.prototype.getKey(this);}"
	  }
	],
	"warps":
	{
		"dystopianZone-subway": {"row": 18, "column": 3, "targetMap": "subway1", "targetWarp": "subway-dystopianZone"}
	}
}