{
	"tileset": "Etiles",
	"grid": [[ 3, 3, 3, 3, 3, 3, 3, 3, 3, 3, 3, 3, 3, 3, 3, 3, 3, 3, 3, 3, 3, 3, 3, 3, 3, 3, 3, 3, 3, 3, 3, 3, 3, 3, 3, 3, 3, 3, 3, 3, 3, 3, 3, 3, 3, 3, 3, 3, 3, 3, 3, 3, 3, 3, 3, 3, 3, 3, 3, 3, 3, 3, 3, 3, 3, 3, 3, 3, 3, 3, 3, 3, 3, 3, 3, 3, 3, 3, 3, 3, 3, 3, 3, 3, 3, 3, 3, 3, 3, 3, 3, 3, 3, 3, 3, 3, 3, 3, 3,3],
			 [ 3, 8, 8, 3, 8, 8, 3, 8, 8, 3, 8, 8, 3, 8, 8, 3, 8, 8, 3, 8, 8, 3, 8, 8, 3, 8, 8, 3, 8, 8, 3, 8, 8, 3, 8, 8, 3, 8, 8, 3, 8, 8, 3, 8, 8, 3, 8, 8, 3, 8, 8, 3, 8, 8, 3, 8, 8, 3, 8, 8, 3, 8, 8, 3, 8, 8, 3, 8, 8, 3, 8, 8, 3, 8, 8, 3, 8, 8, 3, 8, 8, 3, 8, 8, 3, 8, 8, 3, 8, 8, 3, 8, 8, 3, 8, 8, 3, 8, 8,3],
			 [ 3, 8, 8, 3, 8, 8, 3, 8, 8, 3, 8, 8, 3, 8, 8, 3, 8, 8, 3, 8, 8, 3, 8, 8, 3, 8, 8, 3, 8, 8, 3, 8, 8, 3, 8, 8, 3, 8, 8, 3, 8, 8, 3, 8, 8, 3, 8, 8, 3, 8, 8, 3, 8, 8, 3, 8, 8, 3, 8, 8, 3, 8, 8, 3, 8, 8, 3, 8, 8, 3, 8, 8, 3, 8, 8, 3, 8, 8, 3, 8, 8, 3, 8, 8, 3, 8, 8, 3, 8, 8, 3, 8, 8, 3, 8, 8, 3, 8, 8,3],
			 [ 3, 3, 3, 3, 3, 3, 3, 3, 3, 3, 3, 3, 3, 3, 3, 3, 3, 3, 3, 3, 3, 3, 3, 3, 3, 3, 3, 3, 3, 3, 3, 3, 3, 3, 3, 3, 3, 3, 3, 3, 3, 3, 3, 3, 3, 3, 3, 3, 3, 3, 3, 3, 3, 3, 3, 3, 3, 3, 3, 3, 3, 3, 3, 3, 3, 3, 3, 3, 3, 3, 3, 3, 3, 3, 3, 3, 3, 3, 3, 3, 3, 3, 3, 3, 3, 3, 3, 3, 3, 3, 3, 3, 3, 3, 3, 3, 3, 3, 3,3],
			 [ 3, 8, 8, 3, 8, 8, 3, 8, 8, 3, 8, 8, 3, 8, 8, 3, 8, 8, 3, 8, 8, 3, 8, 8, 3, 8, 8, 3, 8, 8, 3, 8, 8, 3, 8, 8, 3, 8, 8, 3, 8, 8, 3, 8, 8, 3, 8, 8, 3, 8, 8, 3, 8, 8, 3, 8, 8, 3, 8, 8, 3, 8, 8, 3, 8, 8, 3, 8, 8, 3, 8, 8, 3, 8, 8, 3, 8, 8, 3, 8, 8, 3, 8, 8, 3, 8, 8, 3, 8, 8, 3, 8, 8, 3, 8, 8, 3, 8, 8,3],
			 [ 3, 8, 8, 3, 8, 8, 3, 8, 8, 3, 8, 8, 3, 8, 8, 3, 8, 8, 3, 8, 8, 3, 8, 8, 3, 8, 8, 3, 8, 8, 3, 8, 8, 3, 8, 8, 3, 8, 8, 3, 8, 8, 3, 8, 8, 3, 8, 8, 3, 8, 8, 3, 8, 8, 3, 8, 8, 3, 8, 8, 3, 8, 8, 3, 8, 8, 3, 8, 8, 3, 8, 8, 3, 8, 8, 3, 8, 8, 3, 8, 8, 3, 8, 8, 3, 8, 8, 3, 8, 8, 3, 8, 8, 3, 8, 8, 3, 8, 8,3],
			 [ 3, 3, 3, 3, 3, 3, 3, 3, 3, 3, 3, 3, 3, 3, 3, 3, 3, 3, 3, 3, 3, 3, 3, 3, 3, 3, 3, 3, 3, 3, 3, 3, 3, 3, 3, 3, 3, 3, 3, 3, 3, 3, 3, 3, 3, 3, 3, 3, 3, 3, 3, 3, 3, 3, 3, 3, 3, 3, 3, 3, 3, 3, 3, 3, 3, 3, 3, 3, 3, 3, 3, 3, 3, 3, 3, 3, 3, 3, 3, 3, 3, 3, 3, 3, 3, 3, 3, 3, 3, 3, 3, 3, 3, 3, 3, 3, 3, 3, 3,3],
			 [ 3, 8, 8, 3, 8, 8, 3, 8, 8, 3, 8, 8, 3, 8, 8, 3, 8, 8, 3, 8, 8, 3, 8, 8, 3, 8, 8, 3, 8, 8, 3, 8, 8, 3, 8, 8, 3, 8, 8, 3, 8, 8, 3, 8, 8, 3, 8, 8, 3, 8, 8, 3, 8, 8, 3, 8, 8, 3, 8, 8, 3, 8, 8, 3, 8, 8, 3, 8, 8, 3, 8, 8, 3, 8, 8, 3, 8, 8, 3, 8, 8, 3, 8, 8, 3, 8, 8, 3, 8, 8, 3, 8, 8, 3, 8, 8, 3, 8, 8,3],
			 [ 3, 8, 8, 3, 8, 8, 3, 8, 8, 3, 8, 8, 3, 8, 8, 3, 8, 8, 3, 8, 8, 3, 8, 8, 3, 8, 8, 3, 8, 8, 3, 8, 8, 3, 8, 8, 3, 8, 8, 3, 8, 8, 3, 8, 8, 3, 8, 8, 3, 8, 8, 3, 8, 8, 3, 8, 8, 3, 8, 8, 3, 8, 8, 3, 8, 8, 3, 8, 8, 3, 8, 8, 3, 8, 8, 3, 8, 8, 3, 8, 8, 3, 8, 8, 3, 8, 8, 3, 8, 8, 3, 8, 8, 3, 8, 8, 3, 8, 8,3],
			 [ 3, 3, 3, 3, 3, 3, 3, 3, 3, 3, 3, 3, 3, 3, 3, 3, 3, 3, 3, 3, 3, 3, 3, 3, 3, 3, 3, 3, 3, 3, 3, 3, 3, 3, 3, 3, 3, 3, 3, 3, 3, 3, 3, 3, 3, 3, 3, 3, 3, 3, 3, 3, 3, 3, 3, 3, 3, 3, 3, 3, 3, 3, 3, 3, 3, 3, 3, 3, 3, 3, 3, 3, 3, 3, 3, 3, 3, 3, 3, 3, 3, 3, 3, 3, 3, 3, 3, 3, 3, 3, 3, 3, 3, 3, 3, 3, 3, 3, 3,3],
			 [ 3, 8, 8, 3, 8, 8, 3, 8, 8, 3, 8, 8, 3, 8, 8, 3, 8, 8, 3, 8, 8, 3, 8, 8, 3, 8, 8, 3, 8, 8, 3, 8, 8, 3, 8, 8, 3, 8, 8, 3, 8, 8, 3, 8, 8, 3, 8, 8, 3, 8, 8, 3, 8, 8, 3, 8, 8, 3, 8, 8, 3, 8, 8, 3, 8, 8, 3, 8, 8, 3, 8, 8, 3, 8, 8, 3, 8, 8, 3, 8, 8, 3, 8, 8, 3, 8, 8, 3, 8, 8, 3, 8, 8, 3, 8, 8, 3, 8, 8,3],
			 [ 3, 8, 8, 3, 8, 8, 3, 8, 8, 3, 8, 8, 3, 8, 8, 3, 8, 8, 3, 8, 8, 3, 8, 8, 3, 8, 8, 3, 8, 8, 3, 8, 8, 3, 8, 8, 3, 8, 8, 3, 8, 8, 3, 8, 8, 3, 8, 8, 3, 8, 8, 3, 8, 8, 3, 8, 8, 3, 8, 8, 3, 8, 8, 3, 8, 8, 3, 8, 8, 3, 8, 8, 3, 8, 8, 3, 8, 8, 3, 8, 8, 3, 8, 8, 3, 8, 8, 3, 8, 8, 3, 8, 8, 3, 8, 8, 3, 8, 8,3],
			 [ 3, 3, 3, 3, 3, 3, 3, 3, 3, 3, 3, 3, 3, 3, 3, 3, 3, 3, 3, 3, 3, 3, 3, 3, 3, 3, 3, 3, 3, 3, 3, 3, 3, 3, 3, 3, 3, 3, 3, 3, 3, 3, 3, 3, 3, 3, 3, 3, 3, 3, 3, 3, 3, 3, 3, 3, 3, 3, 3, 3, 3, 3, 3, 3, 3, 3, 3, 3, 3, 3, 3, 3, 3, 3, 3, 3, 3, 3, 3, 3, 3, 3, 3, 3, 3, 3, 3, 3, 3, 3, 3, 3, 3, 3, 3, 3, 3, 3, 3,3],
			 [ 3, 8, 8, 3, 8, 8, 3, 8, 8, 3, 8, 8, 3, 8, 8, 3, 8, 8, 3, 8, 8, 3, 8, 8, 3, 8, 8, 3, 8, 8, 3, 8, 8, 3, 8, 8, 3, 8, 8, 3, 8, 8, 3, 8, 8, 3, 8, 8, 3, 8, 8, 3, 8, 8, 3, 8, 8, 3, 8, 8, 3, 8, 8, 3, 8, 8, 3, 8, 8, 3, 8, 8, 3, 8, 8, 3, 8, 8, 3, 8, 8, 3, 8, 8, 3, 8, 8, 3, 8, 8, 3, 8, 8, 3, 8, 8, 3, 8, 8,3],
			 [ 3, 8, 8, 3, 8, 8, 3, 8, 8, 3, 8, 8, 3, 8, 8, 3, 8, 8, 3, 8, 8, 3, 8, 8, 3, 8, 8, 3, 8, 8, 3, 8, 8, 3, 8, 8, 3, 8, 8, 3, 8, 8, 3, 8, 8, 3, 8, 8, 3, 8, 8, 3, 8, 8, 3, 8, 8, 3, 8, 8, 3, 8, 8, 3, 8, 8, 3, 8, 8, 3, 8, 8, 3, 8, 8, 3, 8, 8, 3, 8, 8, 3, 8, 8, 3, 8, 8, 3, 8, 8, 3, 8, 8, 3, 8, 8, 3, 8, 8,3],
			 [ 3, 3, 3, 3, 3, 3, 3, 3, 3, 3, 3, 3, 3, 3, 3, 3, 3, 3, 3, 3, 3, 3, 3, 3, 3, 3, 3, 3, 3, 3, 3, 3, 3, 3, 3, 3, 3, 3, 3, 3, 3, 3, 3, 3, 3, 3, 3, 3, 3, 3, 3, 3, 3, 3, 3, 3, 3, 3, 3, 3, 3, 3, 3, 3, 3, 3, 3, 3, 3, 3, 3, 3, 3, 3, 3, 3, 3, 3, 3, 3, 3, 3, 3, 3, 3, 3, 3, 3, 3, 3, 3, 3, 3, 3, 3, 3, 3, 3, 3,3],
			 [ 3, 8, 8, 3, 8, 8, 3, 8, 8, 3, 8, 8, 3, 8, 8, 3, 8, 8, 3, 8, 8, 3, 8, 8, 3, 8, 8, 3, 8, 8, 3, 8, 8, 3, 8, 8, 3, 8, 8, 3, 8, 8, 3, 8, 8, 3, 8, 8, 3, 8, 8, 3, 8, 8, 3, 8, 8, 3, 8, 8, 3, 8, 8, 3, 8, 8, 3, 8, 8, 3, 8, 8, 3, 8, 8, 3, 8, 8, 3, 8, 8, 3, 8, 8, 3, 8, 8, 3, 8, 8, 3, 8, 8, 3, 8, 8, 3, 8, 8,3],
			 [ 3, 8, 8, 3, 8, 8, 3, 8, 8, 3, 8, 8, 3, 8, 8, 3, 8, 8, 3, 8, 8, 3, 8, 8, 3, 8, 8, 3, 8, 8, 3, 8, 8, 3, 8, 8, 3, 8, 8, 3, 8, 8, 3, 8, 8, 3, 8, 8, 3, 8, 8, 3, 8, 8, 3, 8, 8, 3, 8, 8, 3, 8, 8, 3, 8, 8, 3, 8, 8, 3, 8, 8, 3, 8, 8, 3, 8, 8, 3, 8, 8, 3, 8, 8, 3, 8, 8, 3, 8, 8, 3, 8, 8, 3, 8, 8, 3, 8, 8,3],
			 [ 3, 3, 3, 3, 3, 3, 3, 3, 3, 3, 3, 3, 3, 3, 3, 3, 3, 3, 3, 3, 3, 3, 3, 3, 3, 3, 3, 3, 3, 3, 3, 3, 3, 3, 3, 3, 3, 3, 3, 3, 3, 3, 3, 3, 3, 3, 3, 3, 3, 3, 3, 3, 3, 3, 3, 3, 3, 3, 3, 3, 3, 3, 3, 3, 3, 3, 3, 3, 3, 3, 3, 3, 3, 3, 3, 3, 3, 3, 3, 3, 3, 3, 3, 3, 3, 3, 3, 3, 3, 3, 3, 3, 3, 3, 3, 3, 3, 3, 3,3],
			 [ 3, 8, 8, 3, 8, 8, 3, 8, 8, 3, 8, 8, 3, 8, 8, 3, 8, 8, 3, 8, 8, 3, 8, 8, 3, 8, 8, 3, 8, 8, 3, 8, 8, 3, 8, 8, 3, 8, 8, 3, 8, 8, 3, 8, 8, 3, 8, 8, 3, 8, 8, 3, 8, 8, 3, 8, 8, 3, 8, 8, 3, 8, 8, 3, 8, 8, 3, 8, 8, 3, 8, 8, 3, 8, 8, 3, 8, 8, 3, 8, 8, 3, 8, 8, 3, 8, 8, 3, 8, 8, 3, 8, 8, 3, 8, 8, 3, 8, 8,3],
			 [ 3, 8, 8, 3, 8, 8, 3, 8, 8, 3, 8, 8, 3, 8, 8, 3, 8, 8, 3, 8, 8, 3, 8, 8, 3, 8, 8, 3, 8, 8, 3, 8, 8, 3, 8, 8, 3, 8, 8, 3, 8, 8, 3, 8, 8, 3, 8, 8, 3, 8, 8, 3, 8, 8, 3, 8, 8, 3, 8, 8, 3, 8, 8, 3, 8, 8, 3, 8, 8, 3, 8, 8, 3, 8, 8, 3, 8, 8, 3, 8, 8, 3, 8, 8, 3, 8, 8, 3, 8, 8, 3, 8, 8, 3, 8, 8, 3, 8, 8,3],
			 [ 3, 3, 3, 3, 3, 3, 3, 3, 3, 3, 3, 3, 3, 3, 3, 3, 3, 3, 3, 3, 3, 3, 3, 3, 3, 3, 3, 3, 3, 3, 3, 3, 3, 3, 3, 3, 3, 3, 3, 3, 3, 3, 3, 3, 3, 3, 3, 3, 3, 3, 3, 3, 3, 3, 3, 3, 3, 3, 3, 3, 3, 3, 3, 3, 3, 3, 3, 3, 3, 3, 3, 3, 3, 3, 3, 3, 3, 3, 3, 3, 3, 3, 3, 3, 3, 3, 3, 3, 3, 3, 3, 3, 3, 3,12,13,13,13,14,3],
			 [ 3, 8, 8, 3, 8, 8, 3, 8, 8, 3, 8, 8, 3, 8, 8, 3, 8, 8, 3, 8, 8, 3, 8, 8, 3, 8, 8, 3, 8, 8, 3, 8, 8, 3, 8, 8, 3, 8, 8, 3, 8, 8, 3, 8, 8, 3, 8, 8, 3, 8, 8, 3, 8, 8, 3, 8, 8, 3, 8, 8, 3, 8, 8, 3, 8, 8, 3, 8, 8, 3, 8, 8, 3, 8, 8, 3, 8, 8, 3, 8, 8, 3, 8, 8, 3, 8, 8, 3, 8, 8, 3, 8, 8, 3,18,19,19,19,20,3],
			 [ 3, 8, 8, 3, 8, 8, 3, 8, 8, 3, 8, 8, 3, 8, 8, 3, 8, 8, 3, 8, 8, 3, 8, 8, 3, 8, 8, 3, 8, 8, 3, 8, 8, 3, 8, 8, 3, 8, 8, 3, 8, 8, 3, 8, 8, 3, 8, 8, 3, 8, 8, 3, 8, 8, 3, 8, 8, 3, 8, 8, 3, 8, 8, 3, 8, 8, 3, 8, 8, 3, 8, 8, 3, 8, 8, 3, 8, 8, 3, 8, 8, 3, 8, 8, 3, 8, 8, 3, 8, 8, 3, 8, 8, 3,24,25,25,25,26,3],
			 [ 3, 3, 3, 3, 3, 3, 3, 3, 3, 3, 3, 3, 3, 3, 3, 3, 3, 3, 3, 3, 3, 3, 3, 3, 3, 3, 3, 3, 3, 3, 3, 3, 3, 3, 3, 3, 3, 3, 3, 3, 3, 3, 3, 3, 3, 3, 3, 3, 3, 3, 3, 3, 3, 3, 3, 3, 3, 3, 3, 3, 3, 3, 3, 3, 3, 3, 3, 3, 3, 3, 3, 3, 3, 3, 3, 3, 3, 3, 3, 3, 3, 3, 3, 3, 3, 3, 3, 3, 3, 3, 3, 3, 3, 3,30,31,31,31,35,3],
			 [ 3, 8, 8, 3, 8, 8, 3, 8, 8, 3, 8, 8, 3, 8, 8, 3, 8, 8, 3, 8, 8, 3, 8, 8, 3, 8, 8, 3, 8, 8, 3, 8, 8, 3, 8, 8, 3, 8, 8, 3, 8, 8, 3, 8, 8, 3, 8, 8, 3, 8, 8, 3, 8, 8, 3, 8, 8, 3, 8, 8, 3, 8, 8, 3, 8, 8, 3, 8, 8, 3, 8, 8, 3, 8, 8, 3, 8, 8, 3, 8, 8, 3, 8, 8, 3, 8, 8, 3, 8, 8, 3, 8, 8, 3,30,31,32,33,35,3],
			 [ 3, 8, 8, 3, 8, 8, 3, 8, 8, 3, 8, 8, 3, 8, 8, 3, 8, 8, 3, 8, 8, 3, 8, 8, 3, 8, 8, 3, 8, 8, 3, 8, 8, 3, 8, 8, 3, 8, 8, 3, 8, 8, 3, 8, 8, 3, 8, 8, 3, 8, 8, 3, 8, 8, 3, 8, 8, 3, 8, 8, 3, 8, 8, 3, 8, 8, 3, 8, 8, 3, 8, 8, 3, 8, 8, 3, 8, 8, 3, 8, 8, 3, 8, 8, 3, 8, 8, 3, 8, 8, 3, 8, 8, 3,30,31,31,31,35,3],
			 [ 3, 3, 3, 3, 3, 3, 3, 3, 3, 3, 3, 3, 3, 3, 3, 3, 3, 3, 3, 3, 3, 3, 3, 3, 3, 3, 3, 3, 3, 3, 3, 3, 3, 3, 3, 3, 3, 3, 3, 3, 3, 3, 3, 3, 3, 3, 3, 3, 3, 3, 3, 3, 3, 3, 3, 3, 3, 3, 3, 3, 3, 3, 3, 3, 3, 3, 3, 3, 3, 3, 3, 3, 3, 3, 3, 3, 3, 3, 3, 3, 3, 3, 3, 3, 3, 3, 3, 3, 3, 3, 3, 3, 3, 3,36,37,37,42,41,3],
			 [ 3, 8, 8, 3, 8, 8, 3, 8, 8, 3, 8, 8, 3, 8, 8, 3, 8, 8, 3, 8, 8, 3, 8, 8, 3, 8, 8, 3, 8, 8, 3, 8, 8, 3, 8, 8, 3, 8, 8, 3, 8, 8, 3, 8, 8, 3, 8, 8, 3, 8, 8, 3, 8, 8, 3, 8, 8, 3, 8, 8, 3, 8, 8, 3, 8, 8, 3, 8, 8, 3, 8, 8, 3, 8, 8, 3, 8, 8, 3, 8, 8, 3, 8, 8, 3, 8, 8, 3, 8, 8, 3, 8, 8, 3, 8, 8, 3, 8, 8,3],
			 [ 3, 8, 8, 3, 8, 8, 3, 8, 8, 3, 8, 8, 3, 8, 8, 3, 8, 8, 3, 8, 8, 3, 8, 8, 3, 8, 8, 3, 8, 8, 3, 8, 8, 3, 8, 8, 3, 8, 8, 3, 8, 8, 3, 8, 8, 3, 8, 8, 3, 8, 8, 3, 8, 8, 3, 8, 8, 3, 8, 8, 3, 8, 8, 3, 8, 8, 3, 8, 8, 3, 8, 8, 3, 8, 8, 3, 8, 8, 3, 8, 8, 3, 8, 8, 3, 8, 8, 3, 8, 8, 3, 8, 8, 3, 8, 8, 3, 8, 8,3],
			 [ 3, 3, 3, 3, 3, 3, 3, 3, 3, 3, 3, 3, 3, 3, 3, 3, 3, 3, 3, 3, 3, 3, 3, 3, 3, 3, 3, 3, 3, 3, 3, 3, 3, 3, 3, 3, 3, 3, 3, 3, 3, 3, 3, 3, 3, 3, 3, 3, 3, 3, 3, 3, 3, 3, 3, 3, 3, 3, 3, 3, 3, 3, 3, 3, 3, 3, 3, 3, 3, 3, 3, 3, 3, 3, 3, 3, 3, 3, 3, 3, 3, 3, 3, 3, 3, 3, 3, 3, 3, 3, 3, 3, 3, 3, 3, 3, 3, 3, 3,3],
			 [ 3, 8, 8, 3, 8, 8, 3, 8, 8, 3, 8, 8, 3, 8, 8, 3, 8, 8, 3, 8, 8, 3, 8, 8, 3, 8, 8, 3, 8, 8, 3, 8, 8, 3, 8, 8, 3, 8, 8, 3, 8, 8, 3, 8, 8, 3, 8, 8, 3, 8, 8, 3, 8, 8, 3, 8, 8, 3, 8, 8, 3, 8, 8, 3, 8, 8, 3, 8, 8, 3, 8, 8, 3, 8, 8, 3, 8, 8, 3, 8, 8, 3, 8, 8, 3, 8, 8, 3, 8, 8, 3, 8, 8, 3, 8, 8, 3, 8, 8,3],
			 [ 3, 8, 8, 3, 8, 8, 3, 8, 8, 3, 8, 8, 3, 8, 8, 3, 8, 8, 3, 8, 8, 3, 8, 8, 3, 8, 8, 3, 8, 8, 3, 8, 8, 3, 8, 8, 3, 8, 8, 3, 8, 8, 3, 8, 8, 3, 8, 8, 3, 8, 8, 3, 8, 8, 3, 8, 8, 3, 8, 8, 3, 8, 8, 3, 8, 8, 3, 8, 8, 3, 8, 8, 3, 8, 8, 3, 8, 8, 3, 8, 8, 3, 8, 8, 3, 8, 8, 3, 8, 8, 3, 8, 8, 3, 8, 8, 3, 8, 8,3],
			 [ 3, 3, 3, 3, 3, 3, 3, 3, 3, 3, 3, 3, 3, 3, 3, 3, 3, 3, 3, 3, 3, 3, 3, 3, 3, 3, 3, 3, 3, 3, 3, 3, 3, 3, 3, 3, 3, 3, 3, 3, 3, 3, 3, 3, 3, 3, 3, 3, 3, 3, 3, 3, 3, 3, 3, 3, 3, 3, 3, 3, 3, 3, 3, 3, 3, 3, 3, 3, 3, 3, 3, 3, 3, 3, 3, 3, 3, 3, 3, 3, 3, 3, 3, 3, 3, 3, 3, 3, 3, 3, 3, 3, 3, 3, 3, 3, 3, 3, 3,3],
			 [ 3, 8, 8, 3, 8, 8, 3, 8, 8, 3, 8, 8, 3, 8, 8, 3, 8, 8, 3, 8, 8, 3, 8, 8, 3, 8, 8, 3, 8, 8, 3, 8, 8, 3, 8, 8, 3, 8, 8, 3, 8, 8, 3, 8, 8, 3, 8, 8, 3, 8, 8, 3, 8, 8, 3, 8, 8, 3, 8, 8, 3, 8, 8, 3, 8, 8, 3, 8, 8, 3, 8, 8, 3, 8, 8, 3, 8, 8, 3, 8, 8, 3, 8, 8, 3, 8, 8, 3, 8, 8, 3, 8, 8, 3, 8, 8, 3, 8, 8,3],
			 [ 3, 8, 8, 3, 8, 8, 3, 8, 8, 3, 8, 8, 3, 8, 8, 3, 8, 8, 3, 8, 8, 3, 8, 8, 3, 8, 8, 3, 8, 8, 3, 8, 8, 3, 8, 8, 3, 8, 8, 3, 8, 8, 3, 8, 8, 3, 8, 8, 3, 8, 8, 3, 8, 8, 3, 8, 8, 3, 8, 8, 3, 8, 8, 3, 8, 8, 3, 8, 8, 3, 8, 8, 3, 8, 8, 3, 8, 8, 3, 8, 8, 3, 8, 8, 3, 8, 8, 3, 8, 8, 3, 8, 8, 3, 8, 8, 3, 8, 8,3],
			 [ 3, 3, 3, 3, 3, 3, 3, 3, 3, 3, 3, 3, 3, 3, 3, 3, 3, 3, 3, 3, 3, 3, 3, 3, 3, 3, 3, 3, 3, 3, 3, 3, 3, 3, 3, 3, 3, 3, 3, 3, 3, 3, 3, 3, 3, 3, 3, 3, 3, 3, 3, 3, 3, 3, 3, 3, 3, 3, 3, 3, 3, 3, 3, 3, 3, 3, 3, 3, 3, 3, 3, 3, 3, 3, 3, 3, 3, 3, 3, 3, 3, 3, 3, 3, 3, 3, 3, 3, 3, 3, 3, 3, 3, 3, 3, 3, 3, 3, 3,3],
			 [ 3, 8, 8, 3, 8, 8, 3, 8, 8, 3, 8, 8, 3, 8, 8, 3, 8, 8, 3, 8, 8, 3, 8, 8, 3, 8, 8, 3, 8, 8, 3, 8, 8, 3, 8, 8, 3, 8, 8, 3, 8, 8, 3, 8, 8, 3, 8, 8, 3, 8, 8, 3, 8, 8, 3, 8, 8, 3, 8, 8, 3, 8, 8, 3, 8, 8, 3, 8, 8, 3, 8, 8, 3, 8, 8, 3, 8, 8, 3, 8, 8, 3, 8, 8, 3, 8, 8, 3, 8, 8, 3, 8, 8, 3, 8, 8, 3, 8, 8,3],
			 [ 3, 8, 8, 3, 8, 8, 3, 8, 8, 3, 8, 8, 3, 8, 8, 3, 8, 8, 3, 8, 8, 3, 8, 8, 3, 8, 8, 3, 8, 8, 3, 8, 8, 3, 8, 8, 3, 8, 8, 3, 8, 8, 3, 8, 8, 3, 8, 8, 3, 8, 8, 3, 8, 8, 3, 8, 8, 3, 8, 8, 3, 8, 8, 3, 8, 8, 3, 8, 8, 3, 8, 8, 3, 8, 8, 3, 8, 8, 3, 8, 8, 3, 8, 8, 3, 8, 8, 3, 8, 8, 3, 8, 8, 3, 8, 8, 3, 8, 8,3],
			 [ 3, 3, 3, 3, 3, 3, 3, 3, 3, 3, 3, 3, 3, 3, 3, 3, 3, 3, 3, 3, 3, 3, 3, 3, 3, 3, 3, 3, 3, 3, 3, 3, 3, 3, 3, 3, 3, 3, 3, 3, 3, 3, 3, 3, 3, 3, 3, 3, 3, 3, 3, 3, 3, 3, 3, 3, 3, 3, 3, 3, 3, 3, 3, 3, 3, 3, 3, 3, 3, 3, 3, 3, 3, 3, 3, 3, 3, 3, 3, 3, 3, 3, 3, 3, 3, 3, 3, 3, 3, 3, 3, 3, 3, 3, 3, 3, 3, 3, 3,3],
			 [ 3, 8, 8, 3, 8, 8, 3, 8, 8, 3, 8, 8, 3, 8, 8, 3, 8, 8, 3, 8, 8, 3, 8, 8, 3, 8, 8, 3, 8, 8, 3, 8, 8, 3, 8, 8, 3, 8, 8, 3, 8, 8, 3, 8, 8, 3, 8, 8, 3, 8, 8, 3, 8, 8, 3, 8, 8, 3, 8, 8, 3, 8, 8, 3, 8, 8, 3, 8, 8, 3, 8, 8, 3, 8, 8, 3, 8, 8, 3, 8, 8, 3, 8, 8, 3, 8, 8, 3, 8, 8, 3, 8, 8, 3, 8, 8, 3, 8, 8,3],
			 [ 3, 8, 8, 3, 8, 8, 3, 8, 8, 3, 8, 8, 3, 8, 8, 3, 8, 8, 3, 8, 8, 3, 8, 8, 3, 8, 8, 3, 8, 8, 3, 8, 8, 3, 8, 8, 3, 8, 8, 3, 8, 8, 3, 8, 8, 3, 8, 8, 3, 8, 8, 3, 8, 8, 3, 8, 8, 3, 8, 8, 3, 8, 8, 3, 8, 8, 3, 8, 8, 3, 8, 8, 3, 8, 8, 3, 8, 8, 3, 8, 8, 3, 8, 8, 3, 8, 8, 3, 8, 8, 3, 8, 8, 3, 8, 8, 3, 8, 8,3],
			 [ 3, 3, 3, 3, 3, 3, 3, 3, 3, 3, 3, 3, 3, 3, 3, 3, 3, 3, 3, 3, 3, 3, 3, 3, 3, 3, 3, 3, 3, 3, 3, 3, 3, 3, 3, 3, 3, 3, 3, 3, 3, 3, 3, 3, 3, 3, 3, 3, 3, 3, 3, 3, 3, 3, 3, 3, 3, 3, 3, 3, 3, 3, 3, 3, 3, 3, 3, 3, 3, 3, 3, 3, 3, 3, 3, 3, 3, 3, 3, 3, 3, 3, 3, 3, 3, 3, 3, 3, 3, 3, 3, 3, 3, 3, 3, 3, 3, 3, 3,3]
			 ],
	"adjacency": [null,null,null,null],
	"tileType": {"walk": [0,1,6,7, 8,9,10,11,15,16,17,21,22,23,45,47]},
	"entities":
	[
	],
	"warps":
	{
		"egyptZone-subway": {"row": 27, "column": 97, "targetMap": "subway1", "targetWarp": "subway-egyptZone"}
	}
}