{
	"tileset": "Etiles",
	"grid": [[ 4, 4, 4, 4, 4, 4, 4, 4, 4, 4, 4, 4, 4, 4, 4, 4, 4, 4, 4, 4, 4, 4, 4, 4, 4, 4, 4, 4, 4, 4, 4, 4, 4, 4, 4, 4, 4, 4, 4, 4, 4, 4, 4, 4, 4, 4, 4, 4, 4, 4, 4, 4, 4, 4, 4, 4, 4, 4, 4, 4, 4, 4, 4, 4, 4, 4, 4, 4, 4, 4, 4, 4, 4, 4, 4, 4, 4, 4, 4, 4, 4, 4, 4, 4, 4, 4, 4, 4, 4, 4, 4, 4, 4, 4, 4, 4, 4, 4, 4, 4],
			 [ 4,25,25, 4,25,25, 4,25,25, 4,25,25, 4,25,25, 4,25,25, 4,25,25, 4,25,25, 4,25,25, 4,25,25, 4,25,25, 4,25,25, 4,25,25, 4,25,25, 4,25,25, 4,25,25, 4,25,25, 4,25,25, 4,25,25, 4,25,25, 4,25,25, 4,25,25, 4,25,25, 4,25,25, 4,25,25, 4,25,25, 4,25,25, 4,25,25, 4,25,25, 4,25,25, 4,25,25, 4,25,25, 4,25,25, 4],
			 [ 4,25,25, 4,25,25, 4,25,25, 4,25,25, 4,25,25, 4,25,25, 4,25,25, 4,25,25, 4,25,25, 4,25,25, 4,25,25, 4,25,25, 4,25,25, 4,25,25, 4,25,25, 4,25,25, 4,25,25, 4,25,25, 4,25,25, 4,25,25, 4,25,25, 4,25,25, 4,25,25, 4,25,25, 4,25,25, 4,25,25, 4,25,25, 4,25,25, 4,25,25, 4,25,25, 4,25,25, 4,25,25, 4,25,25, 4],
			 [ 4, 4, 4, 4, 4, 4, 4, 4, 4, 4, 4, 4, 4, 4, 4, 4, 4, 4, 4, 4, 4, 4, 4, 4, 4, 4, 4, 4, 4, 4, 4, 4, 4, 4, 4, 4, 4, 4, 4, 4, 4, 4, 4, 4, 4, 4, 4, 4, 4, 4, 4, 4, 4, 4, 4, 4, 4, 4, 4, 4, 4, 4, 4, 4, 4, 4, 4, 4, 4, 4, 4, 4, 4, 4, 4, 4, 4, 4, 4, 4, 4, 4, 4, 4, 4, 4, 4, 4, 4, 4, 4, 4, 4, 4, 4, 4, 4, 4, 4, 4],
			 [ 4,25,25, 4,25,25, 4,25,25, 4,25,25, 4,25,25, 4,25,25, 4,25,25, 4,25,25, 4,25,25, 4,25,25, 4,25,25, 4,25,25, 4,25,25, 4,25,25, 4,25,25, 4,25,25, 4,25,25, 4,25,25, 4,25,25, 4,25,25, 4,25,25, 4,25,25, 4,25,25, 4,25,25, 4,25,25, 4,25,25, 4,25,25, 4,25,25, 4,25,25, 4,25,25, 4,25,25, 4,25,25, 4,25,25, 4],
			 [ 4,25,25, 4,25,25, 4,25,25, 4,25,25, 4,25,25, 4,25,25, 4,25,25, 4,25,25, 4,25,25, 4,25,25, 4,25,25, 4,25,25, 4,25,25, 4,25,25, 4,25,25, 4,25,25, 4,25,25, 4,25,25, 4,25,25, 4,25,25, 4,25,25, 4,25,25, 4,25,25, 4,25,25, 4,25,25, 4,25,25, 4,25,25, 4,25,25, 4,25,25, 4,25,25, 4,25,25, 4,25,25, 4,25,25, 4],
			 [ 4, 4, 4, 4, 4, 4, 4, 4, 4, 4, 4, 4, 4, 4, 4, 4, 4, 4, 4, 4, 4, 4, 4, 4, 4, 4, 4, 4, 4, 4, 4, 4, 4, 4, 4, 4, 4, 4, 4, 4, 4, 4, 4, 4, 4, 4, 4, 4, 4, 4, 4, 4, 4, 4, 4, 4, 4, 4, 4, 4, 4, 4, 4, 4, 4, 4, 4, 4, 4, 4, 4, 4, 4, 4, 4, 4, 4, 4, 4, 4, 4, 4, 4, 4, 4, 4, 4, 4, 4, 4, 4, 4, 4, 4, 4, 4, 4, 4, 4, 4],
			 [ 4,25,25, 4,25,25, 4,25,25, 4,25,25, 4,25,25, 4,25,25, 4,25,25, 4,25,25, 4,25,25, 4,25,25, 4,25,25, 4,25,25, 4,25,25, 4,25,25, 4,25,25, 4,25,25, 4,25,25, 4,25,25, 4,25,25, 4,25,25, 4,25,25, 4,25,25, 4,25,25, 4,25,25, 4,25,25, 4,25,25, 4,25,25, 4,25,25, 4,25,25, 4,25,25, 4,25,25, 4,25,25, 4,25,25, 4],
			 [ 4,25,25, 4,25,25, 4,25,25, 4,25,25, 4,25,25, 4,25,25, 4,25,25, 4,25,25, 4,25,25, 4,25,25, 4,25,25, 4,25,25, 4,25,25, 4,25,25, 4,25,25, 4,25,25, 4,25,25, 4,25,25, 4,25,25, 4,25,25, 4,25,25, 4,25,25, 4,25,25, 4,25,25, 4,25,25, 4,25,25, 4,25,25, 4,25,25, 4,25,25, 4,25,25, 4,25,25, 4,25,25, 4,25,25, 4],
			 [ 4, 4, 4, 4, 4, 4, 4, 4, 4, 4, 4, 4, 4, 4, 4, 4, 4, 4, 4, 4, 4, 4, 4, 4, 4, 4, 4, 4, 4, 4, 4, 4, 4, 4, 4, 4, 4, 4, 4, 4, 4, 4, 4, 4, 4, 4, 4, 4, 4, 4, 4, 4, 4, 4, 4, 4, 4, 4, 4, 4, 4, 4, 4, 4, 4, 4, 4, 4, 4, 4, 4, 4, 4, 4, 4, 4, 4, 4, 4, 4, 4, 4, 4, 4, 4, 4, 4, 4, 4, 4, 4, 4, 4, 4, 4, 4, 4, 4, 4, 4],
			 [ 4,25,25, 4,25,25, 4,25,25, 4,25,25, 4,25,25, 4,25,25, 4,25,25, 4,25,25, 4,25,25, 4,25,25, 4,25,25, 4,25,25, 4,25,25, 4,25,25, 4,25,25, 4,25,25, 4,25,25, 4,25,25, 4,25,25, 4,25,25, 4,25,25, 4,25,25, 4,25,25, 4,25,25, 4,25,25, 4,25,25, 4,25,25, 4,25,25, 4,25,25, 4,25,25, 4,25,25, 4,25,25, 4,25,25, 4],
			 [ 4,25,25, 4,25,25, 4,25,25, 4,25,25, 4,25,25, 4,25,25, 4,25,25, 4,25,25, 4,25,25, 4,25,25, 4,25,25, 4,25,25, 4,25,25, 4,25,25, 4,25,25, 4,25,25, 4,25,25, 4,25,25, 4,25,25, 4,25,25, 4,25,25, 4,25,25, 4,25,25, 4,25,25, 4,25,25, 4,25,25, 4,25,25, 4,25,25, 4,25,25, 4,25,25, 4,25,25, 4,25,25, 4,25,25, 4],
			 [ 4, 4, 4, 4, 4, 4, 4, 4, 4, 4, 4, 4, 4, 4, 4, 4, 4, 4, 4, 4, 4, 4, 4, 4, 4, 4, 4, 4, 4, 4, 4, 4, 4, 4, 4, 4, 4, 4, 4, 4, 4, 4, 4, 4, 4, 4, 4, 4, 4, 4, 4, 4, 4, 4, 4, 4, 4, 4, 4, 4, 4, 4, 4, 4, 4, 4, 4, 4, 4, 4, 4, 4, 4, 4, 4, 4, 4, 4, 4, 4, 4, 4, 4, 4, 4, 4, 4, 4, 4, 4, 4, 4, 4, 4, 4, 4, 4, 4, 4, 4],
			 [ 4,25,25, 4,25,25, 4,25,25, 4,25,25, 4,25,25, 4,25,25, 4,25,25, 4,25,25, 4,25,25, 4,25,25, 4,25,25, 4,25,25, 4,25,25, 4,25,25, 4,25,25, 4,25,25, 4,25,25, 4,25,25, 4,25,25, 4,25,25, 4,25,25, 4,25,25, 4,25,25, 4,25,25, 4,25,25, 4,25,25, 4,25,25, 4,25,25, 4,25,25, 4,25,25, 4,25,25, 4,25,25, 4,25,25, 4],
			 [ 4,25,25, 4,25,25, 4,25,25, 4,25,25, 4,25,25, 4,25,25, 4,25,25, 4,25,25, 4,25,25, 4,25,25, 4,25,25, 4,25,25, 4,25,25, 4,25,25, 4,25,25, 4,25,25, 4,25,25, 4,25,25, 4,25,25, 4,25,25, 4,25,25, 4,25,25, 4,25,25, 4,25,25, 4,25,25, 4,25,25, 4,25,25, 4,25,25, 4,25,25, 4,25,25, 4,25,25, 4,25,25, 4,25,25, 4],
			 [ 4, 4, 4, 4, 4, 4, 4, 4, 4, 4, 4, 4, 4, 4, 4, 4, 4, 4, 4, 4, 4, 4, 4, 4, 4, 4, 4, 4, 4, 4, 4, 4, 4, 4, 4, 4, 4, 4, 4, 4, 4, 4, 4, 4, 4, 4, 4, 4, 4, 4, 4, 4, 4, 4, 4, 4, 4, 4, 4, 4, 4, 4, 4, 4, 4, 4, 4, 4, 4, 4, 4, 4, 4, 4, 4, 4, 4, 4, 4, 4, 4, 4, 4, 4, 4, 4, 4, 4, 4, 4, 4, 4, 4, 4, 4, 4, 4, 4, 4, 4],
			 [ 4,25,25, 4,25,25, 4,25,25, 4,25,25, 4,25,25, 4,25,25, 4,25,25, 4,25,25, 4,25,25, 4,25,25, 4,25,25, 4,25,25, 4,25,25, 4,25,25, 4,25,25, 4,25,25, 4,25,25, 4,25,25, 4,25,25, 4,25,25, 4,25,25, 4,25,25, 4,25,25, 4,25,25, 4,25,25, 4,25,25, 4,25,25, 4,25,25, 4,25,25, 4,25,25, 4,25,25, 4,25,25, 4,25,25, 4],
			 [ 4,25,25, 4,25,25, 4,25,25, 4,25,25, 4,25,25, 4,25,25, 4,25,25, 4,25,25, 4,25,25, 4,25,25, 4,25,25, 4,25,25, 4,25,25, 4,25,25, 4,25,25, 4,25,25, 4,25,25, 4,25,25, 4,25,25, 4,25,25, 4,25,25, 4,25,25, 4,25,25, 4,25,25, 4,25,25, 4,25,25, 4,25,25, 4,25,25, 4,25,25, 4,25,25, 4,25,25, 4,25,25, 4,25,25, 4],
			 [ 4, 4, 4, 4, 4, 4, 4, 4, 4, 4, 4, 4, 4, 4, 4, 4, 4, 4, 4, 4, 4, 4, 4, 4, 4, 4, 4, 4, 4, 4, 4, 4, 4, 4, 4, 4, 4, 4, 4, 4, 4, 4, 4, 4, 4, 4, 4, 4, 4, 4, 4, 4, 4, 4, 4, 4, 4, 4,13,13, 4, 4, 4, 4, 4, 4, 4, 4, 4, 4, 4, 4, 4, 4, 4, 4, 4, 4, 4, 4, 4, 4, 4, 4, 4, 4, 4, 4, 4, 4, 4, 4, 4, 4, 4, 4, 4, 4, 4, 4],
			 [ 4,25,25, 4,25,25, 4,25,25, 4,25,25, 4,25,25, 4,25,25, 4,25,25, 4,25,25, 4,25,25, 4,25,25, 4,25,25, 4,25,25, 4,25,25, 4,25,25, 4,25,25, 4,25,25, 4,25,25, 4,25,25, 4,25,25,25,25,25,25,25,25, 4,25,25, 4,25,25, 4,25,25, 4,25,25, 4,25,25, 4,25,25, 4,25,25, 4,25,25, 4,25,25, 4,25,25,25,25,25,25,25,25, 4],
			 [ 4,25,25, 4,25,25, 4,25,25, 4,25,25, 4,25,25, 4,25,25, 4,25,25, 4,25,25, 4,25,25, 4,25,25, 4,25,25, 4,25,25, 4,25,25, 4,25,25, 4,25,25, 4,25,25, 4,25,25, 4,25,25, 4,25,25,25,25,25,25,25,25, 4,25,25, 4,25,25, 4,25,25, 4,25,25, 4,25,25, 4,25,25, 4,25,25, 4,25,25, 4,25,25, 4,25,25,25,25,25,25,25,25, 4],
			 [ 4, 4, 4, 4, 4, 4, 4, 4, 4, 4, 4, 4, 4, 4, 4, 4, 4, 4, 4, 4, 4, 4, 4, 4, 4, 4, 4, 4, 4, 4, 4, 4, 4, 4, 4, 4, 4, 4, 4, 4, 4, 4, 4, 4, 4, 4, 4, 4, 4, 4, 4, 4, 4, 4, 4, 4, 4, 4,25,25, 4, 4, 4, 4, 4, 4, 4, 4, 4, 4, 4, 4, 4, 4, 4, 4, 4, 4, 4, 4, 4, 4, 4, 4, 4, 4, 4, 4, 4, 4, 4,25,25,25,25,25,25,25,25, 4],
			 [ 4,25,25, 4,25,25, 4,25,25, 4,25,25, 4,25,25, 4,25,25, 4,25,25, 4,25,25, 4,25,25, 4,25,25, 4,25,25, 4,25,25, 4,25,25, 4,25,25, 4,25,25, 4,25,25, 4,25,25, 4,25,25, 4,25,25, 4,25,25,25,25,25,25,25,25,25,25,25,25,25,25,25,25,25,25,25,25,25,25,25,25,25,25,25,25,25,25,25,25,25,25,25,25,17,18,25,25,25, 4],
			 [ 4,25,25, 4,25,25, 4,25,25, 4,25,25, 4,25,25, 4,25,25, 4,25,25, 4,25,25, 4,25,25, 4,25,25, 4,25,25, 4,25,25, 4,25,25, 4,25,25, 4,25,25, 4,25,25, 4,25,25, 4,25,25, 4,25,25, 4,25,25,25,25,25,25,25,25,25,25,25,25,25,25,25,25,25,25,25,25,25,25,25,25,25,25,25,25,25,25,25,25,25,25,25,25,19,20,25,25,25, 4],
			 [ 4, 4, 4, 4, 4, 4, 4, 4, 4, 4, 4, 4, 4, 4, 4, 4, 4, 4, 4, 4, 4, 4, 4, 4, 4, 4, 4, 4, 4, 4, 4, 4, 4, 4, 4, 4, 4, 4, 4, 4, 4, 4, 4, 4, 4, 4, 4, 4, 4, 4, 4, 4, 4, 4, 4, 4, 4, 4, 4, 4, 4, 4, 4, 4, 4, 4, 4, 4, 4, 4, 4, 4, 4, 4, 4, 4, 4, 4, 4, 4, 4, 4, 4, 4, 4, 4, 4, 4, 4, 4, 4,25,25,25,25,25,25,25,25, 4],
			 [ 4,25,25, 4,25,25, 4,25,25, 4,25,25, 4,25,25, 4,25,25, 4,25,25, 4,25,25, 4,25,25, 4,25,25, 4,25,25, 4,25,25, 4,25,25, 4,25,25, 4,25,25, 4,25,25, 4,25,25, 4,25,25, 4,25,25, 4,25,25, 4,25,25, 4,25,25, 4,25,25, 4,25,25, 4,25,25, 4,25,25, 4,25,25, 4,25,25, 4,25,25, 4,25,25, 4,25,25,25,25,25,25,25,25, 4],
			 [ 4,25,25, 4,25,25, 4,25,25, 4,25,25, 4,25,25, 4,25,25, 4,25,25, 4,25,25, 4,25,25, 4,25,25, 4,25,25, 4,25,25, 4,25,25, 4,25,25, 4,25,25, 4,25,25, 4,25,25, 4,25,25, 4,25,25, 4,25,25, 4,25,25, 4,25,25, 4,25,25, 4,25,25, 4,25,25, 4,25,25, 4,25,25, 4,25,25, 4,25,25, 4,25,25, 4,25,25,25,25,25,25,25,25, 4],
			 [ 4, 4, 4, 4, 4, 4, 4, 4, 4, 4, 4, 4, 4, 4, 4, 4, 4, 4, 4, 4, 4, 4, 4, 4, 4, 4, 4, 4, 4, 4, 4, 4, 4, 4, 4, 4, 4, 4, 4, 4, 4, 4, 4, 4, 4, 4, 4, 4, 4, 4, 4, 4, 4, 4, 4, 4, 4, 4, 4, 4, 4, 4, 4, 4, 4, 4, 4, 4, 4, 4, 4, 4, 4, 4, 4, 4, 4, 4, 4, 4, 4, 4, 4, 4, 4, 4, 4, 4, 4, 4, 4, 4, 4, 4, 4, 4, 4, 4, 4, 4],
			 [ 4,25,25, 4,25,25, 4,25,25, 4,25,25, 4,25,25, 4,25,25, 4,25,25, 4,25,25, 4,25,25, 4,25,25, 4,25,25, 4,25,25, 4,25,25, 4,25,25, 4,25,25, 4,25,25, 4,25,25, 4,25,25, 4,25,25, 4,25,25, 4,25,25, 4,25,25, 4,25,25, 4,25,25, 4,25,25, 4,25,25, 4,25,25, 4,25,25, 4,25,25, 4,25,25, 4,25,25, 4,25,25, 4,25,25, 4],
			 [ 4,25,25, 4,25,25, 4,25,25, 4,25,25, 4,25,25, 4,25,25, 4,25,25, 4,25,25, 4,25,25, 4,25,25, 4,25,25, 4,25,25, 4,25,25, 4,25,25, 4,25,25, 4,25,25, 4,25,25, 4,25,25, 4,25,25, 4,25,25, 4,25,25, 4,25,25, 4,25,25, 4,25,25, 4,25,25, 4,25,25, 4,25,25, 4,25,25, 4,25,25, 4,25,25, 4,25,25, 4,25,25, 4,25,25, 4],
			 [ 4, 4, 4, 4, 4, 4, 4, 4, 4, 4, 4, 4, 4, 4, 4, 4, 4, 4, 4, 4, 4, 4, 4, 4, 4, 4, 4, 4, 4, 4, 4, 4, 4, 4, 4, 4, 4, 4, 4, 4, 4, 4, 4, 4, 4, 4, 4, 4, 4, 4, 4, 4, 4, 4, 4, 4, 4, 4, 4, 4, 4, 4, 4, 4, 4, 4, 4, 4, 4, 4, 4, 4, 4, 4, 4, 4, 4, 4, 4, 4, 4, 4, 4, 4, 4, 4, 4, 4, 4, 4, 4, 4, 4, 4, 4, 4, 4, 4, 4, 4],
			 [ 4,25,25, 4,25,25, 4,25,25, 4,25,25, 4,25,25, 4,25,25, 4,25,25, 4,25,25, 4,25,25, 4,25,25, 4,25,25, 4,25,25, 4,25,25, 4,25,25, 4,25,25, 4,25,25, 4,25,25, 4,25,25, 4,25,25, 4,25,25, 4,25,25, 4,25,25, 4,25,25, 4,25,25, 4,25,25, 4,25,25, 4,25,25, 4,25,25, 4,25,25, 4,25,25, 4,25,25, 4,25,25, 4,25,25, 4],
			 [ 4,25,25, 4,25,25, 4,25,25, 4,25,25, 4,25,25, 4,25,25, 4,25,25, 4,25,25, 4,25,25, 4,25,25, 4,25,25, 4,25,25, 4,25,25, 4,25,25, 4,25,25, 4,25,25, 4,25,25, 4,25,25, 4,25,25, 4,25,25, 4,25,25, 4,25,25, 4,25,25, 4,25,25, 4,25,25, 4,25,25, 4,25,25, 4,25,25, 4,25,25, 4,25,25, 4,25,25, 4,25,25, 4,25,25, 4],
			 [ 4, 4, 4, 4, 4, 4, 4, 4, 4, 4, 4, 4, 4, 4, 4, 4, 4, 4, 4, 4, 4, 4, 4, 4, 4, 4, 4, 4, 4, 4, 4, 4, 4, 4, 4, 4, 4, 4, 4, 4, 4, 4, 4, 4, 4, 4, 4, 4, 4, 4, 4, 4, 4, 4, 4, 4, 4, 4, 4, 4, 4, 4, 4, 4, 4, 4, 4, 4, 4, 4, 4, 4, 4, 4, 4, 4, 4, 4, 4, 4, 4, 4, 4, 4, 4, 4, 4, 4, 4, 4, 4, 4, 4, 4, 4, 4, 4, 4, 4, 4],
			 [ 4,25,25, 4,25,25, 4,25,25, 4,25,25, 4,25,25, 4,25,25, 4,25,25, 4,25,25, 4,25,25, 4,25,25, 4,25,25, 4,25,25, 4,25,25, 4,25,25, 4,25,25, 4,25,25, 4,25,25, 4,25,25, 4,25,25, 4,25,25, 4,25,25, 4,25,25, 4,25,25, 4,25,25, 4,25,25, 4,25,25, 4,25,25, 4,25,25, 4,25,25, 4,25,25, 4,25,25, 4,25,25, 4,25,25, 4],
			 [ 4,25,25, 4,25,25, 4,25,25, 4,25,25, 4,25,25, 4,25,25, 4,25,25, 4,25,25, 4,25,25, 4,25,25, 4,25,25, 4,25,25, 4,25,25, 4,25,25, 4,25,25, 4,25,25, 4,25,25, 4,25,25, 4,25,25, 4,25,25, 4,25,25, 4,25,25, 4,25,25, 4,25,25, 4,25,25, 4,25,25, 4,25,25, 4,25,25, 4,25,25, 4,25,25, 4,25,25, 4,25,25, 4,25,25, 4],
			 [ 4, 4, 4, 4, 4, 4, 4, 4, 4, 4, 4, 4, 4, 4, 4, 4, 4, 4, 4, 4, 4, 4, 4, 4, 4, 4, 4, 4, 4, 4, 4, 4, 4, 4, 4, 4, 4, 4, 4, 4, 4, 4, 4, 4, 4, 4, 4, 4, 4, 4, 4, 4, 4, 4, 4, 4, 4, 4, 4, 4, 4, 4, 4, 4, 4, 4, 4, 4, 4, 4, 4, 4, 4, 4, 4, 4, 4, 4, 4, 4, 4, 4, 4, 4, 4, 4, 4, 4, 4, 4, 4, 4, 4, 4, 4, 4, 4, 4, 4, 4],
			 [ 4,25,25, 4,25,25, 4,25,25, 4,25,25, 4,25,25, 4,25,25, 4,25,25, 4,25,25, 4,25,25, 4,25,25, 4,25,25, 4,25,25, 4,25,25, 4,25,25, 4,25,25, 4,25,25, 4,25,25, 4,25,25, 4,25,25, 4,25,25, 4,25,25, 4,25,25, 4,25,25, 4,25,25, 4,25,25, 4,25,25, 4,25,25, 4,25,25, 4,25,25, 4,25,25, 4,25,25, 4,25,25, 4,25,25, 4],
			 [ 4,25,25, 4,25,25, 4,25,25, 4,25,25, 4,25,25, 4,25,25, 4,25,25, 4,25,25, 4,25,25, 4,25,25, 4,25,25, 4,25,25, 4,25,25, 4,25,25, 4,25,25, 4,25,25, 4,25,25, 4,25,25, 4,25,25, 4,25,25, 4,25,25, 4,25,25, 4,25,25, 4,25,25, 4,25,25, 4,25,25, 4,25,25, 4,25,25, 4,25,25, 4,25,25, 4,25,25, 4,25,25, 4,25,25, 4],
			 [ 4, 4, 4, 4, 4, 4, 4, 4, 4, 4, 4, 4, 4, 4, 4, 4, 4, 4, 4, 4, 4, 4, 4, 4, 4, 4, 4, 4, 4, 4, 4, 4, 4, 4, 4, 4, 4, 4, 4, 4, 4, 4, 4, 4, 4, 4, 4, 4, 4, 4, 4, 4, 4, 4, 4, 4, 4, 4, 4, 4, 4, 4, 4, 4, 4, 4, 4, 4, 4, 4, 4, 4, 4, 4, 4, 4, 4, 4, 4, 4, 4, 4, 4, 4, 4, 4, 4, 4, 4, 4, 4, 4, 4, 4, 4, 4, 4, 4, 4, 4],
			 [ 4,25,25, 4,25,25, 4,25,25, 4,25,25, 4,25,25, 4,25,25, 4,25,25, 4,25,25, 4,25,25, 4,25,25, 4,25,25, 4,25,25, 4,25,25, 4,25,25, 4,25,25, 4,25,25, 4,25,25, 4,25,25, 4,25,25, 4,25,25, 4,25,25, 4,25,25, 4,25,25, 4,25,25, 4,25,25, 4,25,25, 4,25,25, 4,25,25, 4,25,25, 4,25,25, 4,25,25, 4,25,25, 4,25,25, 4],
			 [ 4,25,25, 4,25,25, 4,25,25, 4,25,25, 4,25,25, 4,25,25, 4,25,25, 4,25,25, 4,25,25, 4,25,25, 4,25,25, 4,25,25, 4,25,25, 4,25,25, 4,25,25, 4,25,25, 4,25,25, 4,25,25, 4,25,25, 4,25,25, 4,25,25, 4,25,25, 4,25,25, 4,25,25, 4,25,25, 4,25,25, 4,25,25, 4,25,25, 4,25,25, 4,25,25, 4,25,25, 4,25,25, 4,25,25, 4],
			 [ 4, 4, 4, 4, 4, 4, 4, 4, 4, 4, 4, 4, 4, 4, 4, 4, 4, 4, 4, 4, 4, 4, 4, 4, 4, 4, 4, 4, 4, 4, 4, 4, 4, 4, 4, 4, 4, 4, 4, 4, 4, 4, 4, 4, 4, 4, 4, 4, 4, 4, 4, 4, 4, 4, 4, 4, 4, 4, 4, 4, 4, 4, 4, 4, 4, 4, 4, 4, 4, 4, 4, 4, 4, 4, 4, 4, 4, 4, 4, 4, 4, 4, 4, 4, 4, 4, 4, 4, 4, 4, 4, 4, 4, 4, 4, 4, 4, 4, 4, 4]
			 ],
	"adjacency": [null,null,null,null],
	"tileType": {"walk": [13,25]},
	"entities":
	[
	  {"type": "Entity",
			"sprite": "yellowkey",
			"position": {"x": 96, "y": 22},
			"dimensions": {"width": 1, "height": 1},
			"animation": [false, "none", true, true],
			"onUse": "function talk(user) {this.output.setMessage([\"'You find the great yellow key:\",\"you pick it up and put it you pocket'\",\"Press the spacebar to continue...'\"]); PC.prototype.getKey(this);}"
	  }
	],
	"warps":
	{
		"egyptZone-subway": {"row": 23, "column": 94, "targetMap": "subway1", "targetWarp": "subway-egyptZone"},
		"egyptZone-subway1": {"row": 23, "column": 95, "targetMap": "subway1", "targetWarp": "subway-egyptZone"},
		"egyptZone-subway2": {"row": 22, "column": 94, "targetMap": "subway1", "targetWarp": "subway-egyptZone"},
		"egyptZone-subway3": {"row": 22, "column": 95, "targetMap": "subway1", "targetWarp": "subway-egyptZone"}
	}
}