{
	"tileset": "pirate",
	"grid": [[73,74,75,76,121,122,123,124,73,74,75,76,121,122,123,124,73,74,75,76,121,122,123,124,73,74,75,76,131,132,131,132,131,132,131,132,131,132,131,132,131,132,131,132,131,132,131,132,131,132],
[89,90,91,92,137,138,139,140,89,90,91,92,137,138,139,140,89,90,91,92,137,138,139,140,89,90,91,92,147,148,147,148,147,148,147,148,147,148,147,148,147,148,147,148,147,148,147,148,147,148],
[105,106,107,108,153,154,155,156,105,106,107,108,153,154,155,156,105,106,107,108,153,154,155,156,105,106,107,108,99,131,131,132,131,132,131,132,131,132,131,132,131,132,131,132,131,132,131,132,131,132],
[16,33,33,16,16,0,0,16,16,0,0,16,16,0,0,16,16,33,33,16,16,50,50,16,16,242,243,16,115,147,147,148,147,148,147,148,147,148,147,148,147,148,147,148,147,148,147,148,147,148],
[32,33,33,32,32,0,0,32,32,0,0,32,32,0,0,32,32,33,33,32,32,50,50,32,32,188,189,32,99,132,131,132,131,132,131,132,131,132,131,132,131,132,131,132,131,132,131,132,131,132],
[48,33,33,48,48,242,243,48,48,242,243,48,48,242,243,48,48,33,33,48,48,50,50,48,48,204,205,48,115,148,147,148,147,148,147,148,147,148,147,148,147,148,147,148,147,148,147,148,147,148],
[33,33,33,174,190,191,192,191,192,191,192,190,191,192,191,192,176,33,33,18,20,50,50,242,243,243,243,243,99,131,131,132,131,132,131,132,131,132,131,132,131,132,131,132,131,132,131,132,131,132],
[33,33,33,33,33,33,33,33,33,33,33,33,33,33,33,33,33,33,33,33,33,33,33,33,33,33,33,33,115,147,147,148,147,148,147,148,147,148,147,148,147,148,147,148,147,148,147,148,147,148],
[206,206,206,13,14,0,0,219,50,219,219,66,67,212,213,66,67,212,213,66,67,212,213,0,85,248,248,33,33,132,131,132,131,132,131,132,131,132,131,132,131,132,131,132,131,132,131,132,131,132],
[206,206,206,29,30,13,14,219,50,201,202,0,0,228,229,0,0,228,229,0,0,228,229,0,86,248,33,33,33,148,147,148,147,148,147,148,147,148,147,148,147,148,147,148,147,148,147,148,147,148],
[0,206,13,14,0,29,30,219,50,217,218,70,70,244,245,70,70,244,245,70,70,244,245,248,248,248,33,113,114,131,131,132,131,132,131,132,131,132,131,132,131,132,131,132,131,132,131,132,131,132],
[0,206,29,30,0,219,219,219,33,33,33,33,33,33,33,33,33,33,33,33,33,33,33,33,209,248,33,129,130,147,147,148,147,148,147,148,147,148,147,148,147,148,147,148,147,148,147,148,147,148],
[248,248,248,248,248,248,248,248,248,248,248,248,248,248,248,248,248,248,248,248,151,163,164,50,225,248,50,221,221,221,221,221,221,221,221,221,221,221,221,221,221,221,221,221,221,221,221,221,221,221],
[248,248,248,248,248,248,248,248,248,248,248,248,248,248,248,248,248,248,173,188,189,179,180,50,241,248,50,70,70,132,131,132,131,132,131,132,131,132,131,132,131,132,131,132,131,84,236,84,131,132],
[248,248,248,248,248,248,248,248,248,248,248,248,248,248,248,248,248,248,173,204,205,195,196,50,50,50,50,70,70,148,147,148,147,148,147,148,147,148,147,148,147,148,147,148,147,84,236,84,147,148],
[248,248,248,248,248,248,248,248,248,248,248,248,248,248,248,248,248,248,173,188,189,97,206,50,209,70,70,70,70,131,131,132,131,132,131,132,131,132,131,132,131,132,131,132,131,84,236,84,131,132],
[248,248,248,248,248,248,248,248,248,248,248,248,248,248,248,248,248,248,173,204,205,50,172,50,225,248,248,248,248,147,147,148,147,148,147,148,147,148,147,148,147,148,147,148,147,84,236,84,147,148],
[248,248,248,248,248,248,248,248,248,248,248,248,248,248,13,14,15,16,173,173,210,50,50,50,241,248,248,248,248,248,248,248,248,248,248,248,248,248,248,248,248,248,248,248,133,134,50,248,248,248],
[248,248,248,248,248,248,248,248,248,248,248,248,248,248,29,30,31,32,248,248,226,248,54,50,149,248,248,248,248,248,248,248,248,248,248,248,188,189,248,248,188,189,248,248,248,248,50,248,248,248],
[248,248,248,248,248,248,248,248,248,248,248,248,248,248,45,46,47,48,248,248,248,248,100,33,201,248,13,14,13,14,15,16,248,13,14,15,16,205,248,248,204,205,248,248,188,189,50,133,134,248],
[248,248,248,248,248,248,248,248,248,248,248,248,248,248,61,62,63,64,248,248,248,248,100,33,217,248,29,30,29,30,31,32,189,29,30,31,32,248,248,248,248,248,248,248,204,205,50,248,248,248],
[248,248,248,248,248,248,248,248,248,248,248,248,248,248,248,248,248,248,100,100,233,234,235,33,201,248,45,46,45,13,14,15,16,45,46,47,48,248,248,248,248,248,248,248,248,248,50,188,189,248],
[248,248,248,248,248,248,248,248,248,248,248,248,248,248,248,248,248,248,100,33,33,33,33,33,217,248,13,14,15,29,30,31,32,61,62,63,64,248,73,74,75,76,248,248,248,248,50,204,205,248],
[248,248,248,248,248,248,248,248,248,248,248,248,248,248,248,248,248,248,185,50,186,100,100,100,100,248,29,30,31,45,46,47,48,48,13,14,15,16,89,90,91,92,248,248,248,248,50,248,248,248],
[248,248,248,248,248,248,248,248,248,248,248,248,248,248,248,248,248,248,185,50,186,186,248,188,189,248,45,46,47,61,62,63,64,64,29,30,31,32,105,106,107,108,248,248,135,136,50,248,248,248],
[248,248,248,248,248,248,248,248,248,248,248,248,248,248,248,248,248,248,185,50,186,186,248,204,205,186,61,62,13,14,15,16,14,15,13,14,15,16,50,50,50,50,50,50,50,50,50,248,248,248],
[248,248,248,248,248,248,248,248,248,248,248,248,248,248,248,248,248,248,185,50,186,186,248,248,248,248,61,62,29,30,31,32,30,31,29,30,31,32,50,249,250,249,250,249,250,251,248,135,136,248],
[248,248,248,248,248,248,248,248,248,248,248,248,248,248,248,248,248,248,185,50,186,186,248,248,13,14,15,16,45,46,47,48,46,47,45,46,47,48,50,173,173,173,173,173,173,173,248,248,248,248],
[248,248,248,248,248,248,248,248,248,248,248,248,248,248,248,99,99,201,201,33,201,201,248,248,29,30,31,13,14,15,16,64,62,63,61,62,63,64,50,45,46,47,48,46,47,48,248,248,248,248],
[248,248,248,248,248,248,248,248,248,248,248,248,248,248,99,115,115,217,217,33,217,217,248,248,45,46,47,29,30,31,32,248,248,248,248,248,248,248,50,61,62,63,64,62,63,64,248,248,248,248],
[248,248,248,248,248,248,248,248,248,248,248,248,248,248,115,33,33,33,33,33,169,170,248,248,61,62,63,45,46,47,48,248,121,122,123,124,248,248,50,248,248,248,135,136,248,248,248,248,248,248],
[248,248,248,248,248,248,248,248,248,248,248,248,248,248,99,33,5,169,170,185,186,248,248,248,248,248,248,61,62,63,64,202,137,138,139,140,202,201,50,201,248,248,248,248,248,248,248,248,248,248],
[248,248,248,248,248,248,248,248,248,248,248,248,248,248,115,33,99,103,104,103,104,103,104,103,104,103,104,248,248,248,248,218,153,154,155,156,218,217,50,217,248,248,248,248,248,248,248,248,248,248],
[248,248,248,248,248,248,248,248,248,248,248,248,248,248,209,33,115,119,120,119,120,119,120,119,120,119,120,50,33,33,50,50,50,50,50,50,50,50,50,50,135,136,248,248,248,248,248,248,248,248],
[248,248,248,248,248,248,248,248,248,248,248,248,248,248,225,33,99,103,104,103,104,103,104,103,104,103,104,50,248,248,248,248,248,248,248,248,248,248,248,248,248,248,248,248,248,248,248,248,248,248],
[248,248,248,248,248,248,248,248,248,248,173,248,248,99,241,33,115,119,120,119,120,119,120,119,120,119,120,50,248,248,248,248,248,248,248,248,248,248,248,248,248,248,248,248,248,248,248,248,248,248],
[248,248,248,248,248,248,248,248,248,248,248,248,248,115,33,33,99,103,104,103,104,103,104,103,104,103,104,50,248,248,248,248,248,248,248,248,248,248,248,248,248,248,248,248,248,248,248,248,248,248],
[248,248,248,248,248,248,248,248,248,248,248,248,248,209,33,99,115,119,120,119,120,119,120,119,120,119,120,50,248,248,248,248,248,248,248,248,248,248,248,248,248,248,248,248,248,248,248,248,248,248],
[248,248,248,248,248,248,248,248,248,248,248,248,248,225,33,115,99,103,104,103,104,103,104,103,104,103,104,50,248,248,248,248,248,248,248,248,248,248,248,248,248,248,248,248,248,248,248,248,248,248],
[248,248,248,248,248,248,248,248,248,248,248,248,248,241,33,33,115,119,120,119,120,119,120,119,120,119,120,50,248,248,248,248,248,248,248,248,248,248,248,248,248,248,248,248,248,248,248,248,248,248],
[77,78,79,80,248,248,248,248,248,248,248,248,248,13,14,33,99,103,104,103,104,103,104,103,104,103,104,33,248,248,248,248,248,248,248,248,248,248,248,248,248,248,248,248,248,248,248,248,248,248],
[93,94,95,96,248,248,248,248,248,248,248,248,248,29,30,33,115,119,120,119,120,119,120,119,120,119,120,33,248,248,248,248,248,248,248,248,248,248,248,248,248,248,248,248,248,248,248,248,248,248],
[109,110,111,112,248,248,248,248,248,248,248,248,248,99,99,33,99,103,104,103,104,103,104,103,104,103,104,33,248,248,248,248,248,248,248,248,248,248,248,248,248,248,248,248,248,248,248,248,248,248],
[125,126,127,128,248,248,248,248,248,248,248,248,248,115,115,33,115,119,120,119,120,119,120,119,120,119,120,33,248,248,248,248,248,248,248,248,248,248,248,248,248,248,248,248,248,248,248,248,248,248],
[141,142,143,144,248,248,248,248,248,248,248,248,248,188,189,33,165,103,104,103,104,103,104,103,104,103,104,33,248,248,248,248,248,248,248,248,248,248,248,248,248,248,248,248,248,248,248,248,248,248],
[157,158,159,160,233,234,235,233,234,235,233,234,235,204,205,33,181,119,120,119,120,119,120,119,120,119,120,33,248,248,248,248,248,248,248,248,248,248,248,248,248,248,248,248,248,248,248,248,248,248],
[33,33,33,33,33,33,33,33,33,33,33,33,33,33,33,33,197,103,104,103,104,103,104,103,104,103,104,33,248,248,248,248,248,248,248,248,248,248,248,248,248,248,248,248,248,248,248,248,248,248],
[248,248,248,248,248,248,248,248,248,248,248,248,248,248,81,33,206,119,120,119,120,119,120,119,120,119,120,33,113,114,248,248,248,248,248,248,248,248,248,248,248,248,248,248,248,248,248,248,248,248],
[248,248,248,248,248,248,248,248,248,248,248,248,248,248,248,33,33,33,33,33,33,33,33,33,33,33,33,33,129,130,248,248,248,248,248,248,248,248,248,248,248,248,248,248,248,248,248,248,248,248],
[248,248,248,248,248,248,248,248,248,248,248,248,248,248,248,248,248,248,248,248,248,248,248,248,248,248,248,248,248,248,248,248,248,248,248,248,248,248,248,248,248,248,248,248,248,248,248,248,248,248]],
	"adjacency": [null,null,null,null],
	"tileType": {"walk": [33,50,215,217,218,216,231,232,233,234,248,289,250]},
	"entities":
	[
	{"type": "Entity",
			"sprite": "graykey",
			"position": {"x": 2, "y": 4},
			"dimensions": {"width": 1, "height": 1},
			"animation": [false, "none", true, true],
			"onUse": "function talk(user) {this.output.setMessage([\"'You find the great gray key:\",\"you pick it up and put it you pocket'\",\"Press the spacebar to continue...'\"]); PC.prototype.getKey(this);}"
	  }
	],
	"warps":
	{
		"evilZone-subway": {"row":46, "column": 1, "targetMap": "subway1", "targetWarp": "subway-evilZone"}
	}
}