{
	"tileset": "tiles",
	"grid": [[3,3,3,3,3,3,3,3,3,3,3,3,3,3,3,3,3,3,3,3,3,3,3,3,3,3,3,3,3,3,3,3,3,3,3,3,3,3,3,3,3,3,3,3,3,3,3,3,3,3,3,3,3,3,3,3,3,3,3,3,3,3,3,3,3,3,3,3,3,3,3,3,3,3,3,3,3,3,3,3,3,3,3,3,3,3,3,3,3,3,3,3,3,3,3,3,3,3,3,3],
			 [3,8,8,3,8,8,3,8,8,3,8,8,3,8,8,3,8,8,3,8,8,3,8,8,3,8,8,3,8,8,3,8,8,3,8,8,3,8,8,3,8,8,3,8,8,3,8,8,3,8,8,3,8,8,3,8,8,3,8,8,3,8,8,3,8,8,3,8,8,3,8,8,3,8,8,3,8,8,3,8,8,3,8,8,3,8,8,3,8,8,3,8,8,3,8,8,3,8,8,3],
			 [3,8,8,3,8,8,3,8,8,3,8,8,3,8,8,3,8,8,3,8,8,3,8,8,3,8,8,3,8,8,3,8,8,3,8,8,3,8,8,3,8,8,3,8,8,3,8,8,3,8,8,3,8,8,3,8,8,3,8,8,3,8,8,3,8,8,3,8,8,3,8,8,3,8,8,3,8,8,3,8,8,3,8,8,3,8,8,3,8,8,3,8,8,3,8,8,3,8,8,3],
			 [3,3,3,3,3,3,3,3,3,3,3,3,3,3,3,3,3,3,3,3,3,3,3,3,3,3,3,3,3,3,3,3,3,3,3,3,3,3,3,3,3,3,3,3,3,3,3,3,3,3,3,3,3,3,3,3,3,3,3,3,3,3,3,3,3,3,3,3,3,3,3,3,3,3,3,3,3,3,3,3,3,3,3,3,3,3,3,3,3,3,3,3,3,3,3,3,3,3,3,3],
			 [3,8,8,3,8,8,3,8,8,3,8,8,3,8,8,3,8,8,3,8,8,3,8,8,3,8,8,3,8,8,3,8,8,3,8,8,3,8,8,3,8,8,3,8,8,3,8,8,3,8,8,3,8,8,3,8,8,3,8,8,3,8,8,3,8,8,3,8,8,3,8,8,3,8,8,3,8,8,3,8,8,3,8,8,3,8,8,3,8,8,3,8,8,3,8,8,3,8,8,3],
			 [3,8,8,3,8,8,3,8,8,3,8,8,3,8,8,3,8,8,3,8,8,3,8,8,3,8,8,3,8,8,3,8,8,3,8,8,3,8,8,3,8,8,3,8,8,3,8,8,3,8,8,3,8,8,3,8,8,3,8,8,3,8,8,3,8,8,3,8,8,3,8,8,3,8,8,3,8,8,3,8,8,3,8,8,3,8,8,3,8,8,3,8,8,3,8,8,3,8,8,3],
			 [3,3,3,3,3,3,3,3,3,3,3,3,3,3,3,3,3,3,3,3,3,3,3,3,3,3,3,3,3,3,3,3,3,3,3,3,3,3,3,3,3,3,3,3,3,3,3,3,3,3,3,3,3,3,3,3,3,3,3,3,3,3,3,3,3,3,3,3,3,3,3,3,3,3,3,3,3,3,3,3,3,3,3,3,3,3,3,3,3,3,3,3,3,3,3,3,3,3,3,3],
			 [3,8,8,3,8,8,3,8,8,3,8,8,3,8,8,3,8,8,3,8,8,3,8,8,3,8,8,3,8,8,3,8,8,3,8,8,3,8,8,3,8,8,3,8,8,3,8,8,3,8,8,3,8,8,3,8,8,3,8,8,3,8,8,3,8,8,3,8,8,3,8,8,3,8,8,3,8,8,3,8,8,3,8,8,3,8,8,3,8,8,3,8,8,3,8,8,3,8,8,3],
			 [3,8,8,3,8,8,3,8,8,3,8,8,3,8,8,3,8,8,3,8,8,3,8,8,3,8,8,3,8,8,3,8,8,3,8,8,3,8,8,3,8,8,3,8,8,3,8,8,3,8,8,3,8,8,3,8,8,3,8,8,3,8,8,3,8,8,3,8,8,3,8,8,3,8,8,3,8,8,3,8,8,3,8,8,3,8,8,3,8,8,3,8,8,3,8,8,3,8,8,3],
			 [3,3,3,3,3,3,3,3,3,3,3,3,3,3,3,3,3,3,3,3,3,3,3,3,3,3,3,3,3,3,3,3,3,3,3,3,3,3,3,3,3,3,3,3,3,3,3,3,3,3,3,3,3,3,3,3,3,3,3,3,3,3,3,3,3,3,3,3,3,3,3,3,3,3,3,3,3,3,3,3,3,3,3,3,3,3,3,3,3,3,3,3,3,3,3,3,3,3,3,3],
			 [3,8,8,3,8,8,3,8,8,3,8,8,3,8,8,3,8,8,3,8,8,3,8,8,3,8,8,3,8,8,3,8,8,3,8,8,3,8,8,3,8,8,3,8,8,3,8,8,3,8,8,3,8,8,3,8,8,3,8,8,3,8,8,3,8,8,3,8,8,3,8,8,3,8,8,3,8,8,3,8,8,3,8,8,3,8,8,3,8,8,3,8,8,3,8,8,3,8,8,3],
			 [3,8,8,3,8,8,3,8,8,3,8,8,3,8,8,3,8,8,3,8,8,3,8,8,3,8,8,3,8,8,3,8,8,3,8,8,3,8,8,3,8,8,3,8,8,3,8,8,3,8,8,3,8,8,3,8,8,3,8,8,3,8,8,3,8,8,3,8,8,3,8,8,3,8,8,3,8,8,3,8,8,3,8,8,3,8,8,3,8,8,3,8,8,3,8,8,3,8,8,3],
			 [3,3,3,3,3,3,3,3,3,3,3,3,3,3,3,3,3,3,3,3,3,3,3,3,3,3,3,3,3,3,3,3,3,3,3,3,3,3,3,3,3,3,3,3,3,3,3,3,3,3,3,3,3,3,3,3,3,3,3,3,3,3,3,3,3,3,3,3,3,3,3,3,3,3,3,3,3,3,3,3,3,3,3,3,3,3,3,3,3,3,3,3,3,3,3,3,3,3,3,3],
			 [3,8,8,3,8,8,3,8,8,3,8,8,3,8,8,3,8,8,3,8,8,3,8,8,3,8,8,3,8,8,3,8,8,3,8,8,3,8,8,3,8,8,3,8,8,3,8,8,3,8,8,3,8,8,3,8,8,3,8,8,3,8,8,3,8,8,3,8,8,3,8,8,3,8,8,3,8,8,3,8,8,3,8,8,3,8,8,3,8,8,3,8,8,3,8,8,3,8,8,3],
			 [3,8,8,3,8,8,3,8,8,3,8,8,3,8,8,3,8,8,3,8,8,3,8,8,3,8,8,3,8,8,3,8,8,3,8,8,3,8,8,3,8,8,3,8,8,3,8,8,3,8,8,3,8,8,3,8,8,3,8,8,3,8,8,3,8,8,3,8,8,3,8,8,3,8,8,3,8,8,3,8,8,3,8,8,3,8,8,3,8,8,3,8,8,3,8,8,3,8,8,3],
			 [3,3,3,3,3,3,3,3,3,3,3,3,3,3,3,3,3,3,3,3,3,3,3,3,3,3,3,3,3,3,3,3,3,3,3,3,3,3,3,3,3,3,3,3,3,3,3,3,3,3,3,3,3,3,3,3,3,3,3,3,3,3,3,3,3,3,3,3,3,3,3,3,3,3,3,3,3,3,3,3,3,3,3,3,3,3,3,3,3,3,3,3,3,3,3,3,3,3,3,3],
			 [3,8,8,3,8,8,3,8,8,3,8,8,3,8,8,3,8,8,3,8,8,3,8,8,3,8,8,3,8,8,3,8,8,3,8,8,3,8,8,3,8,8,3,8,8,3,8,8,3,8,8,3,8,8,3,8,8,3,8,8,3,8,8,3,8,8,3,8,8,3,8,8,3,8,8,3,8,8,3,8,8,3,8,8,3,8,8,3,8,8,3,8,8,3,8,8,3,8,8,3],
			 [3,8,8,3,8,8,3,8,8,3,8,8,3,8,8,3,8,8,3,8,8,3,8,8,3,8,8,3,8,8,3,8,8,3,8,8,3,8,8,3,8,8,3,8,8,3,8,8,3,8,8,3,8,8,3,8,8,3,8,8,3,8,8,3,8,8,3,8,8,3,8,8,3,8,8,3,8,8,3,8,8,3,8,8,3,8,8,3,8,8,3,8,8,3,8,8,3,8,8,3],
			 [3,3,3,3,3,3,3,3,3,3,3,3,3,3,3,3,3,3,3,3,3,3,3,3,3,3,3,3,3,3,3,3,3,3,3,3,3,3,3,3,3,3,3,3,3,3,3,3,3,3,3,3,3,3,3,3,3,3,3,3,3,3,3,3,3,3,3,3,3,3,3,3,3,3,3,3,3,3,3,3,3,3,3,3,3,3,3,3,3,3,3,3,3,3,3,3,3,3,3,3],
			 [3,8,8,3,8,8,3,8,8,3,8,8,3,8,8,3,8,8,3,8,8,3,8,8,3,8,8,3,8,8,3,8,8,3,8,8,3,8,8,3,8,8,3,8,8,3,8,8,3,8,8,3,8,8,3,8,8,3,8,8,3,8,8,3,8,8,3,8,8,3,8,8,3,8,8,3,8,8,3,8,8,3,8,8,3,8,8,3,8,8,3,8,8,3,8,8,3,8,8,3],
			 [3,8,8,3,8,8,3,8,8,3,8,8,3,8,8,3,8,8,3,8,8,3,8,8,3,8,8,3,8,8,3,8,8,3,8,8,3,8,8,3,8,8,3,8,8,3,8,8,3,8,8,3,8,8,3,8,8,3,8,8,3,8,8,3,8,8,3,8,8,3,8,8,3,8,8,3,8,8,3,8,8,3,8,8,3,8,8,3,8,8,3,8,8,3,8,8,3,8,8,3],
			 [3,3,3,3,3,3,3,3,3,3,3,3,3,3,3,3,3,3,3,3,3,3,3,3,3,3,3,3,3,3,3,3,3,3,3,3,3,3,3,3,3,3,3,3,3,3,3,3,3,3,3,3,3,3,3,3,3,3,3,3,3,3,3,3,3,3,3,3,3,3,3,3,3,3,3,3,3,3,3,3,3,3,3,3,3,3,3,3,3,3,3,3,3,3,3,3,3,3,3,3],
			 [3,8,8,3,8,8,3,8,8,3,8,8,3,8,8,3,8,8,3,8,8,3,8,8,3,8,8,3,8,8,3,8,8,3,8,8,3,8,8,3,8,8,3,8,8,3,8,8,3,8,8,3,8,8,3,8,8,3,8,8,3,8,8,3,8,8,3,8,8,3,8,8,3,8,8,3,8,8,3,8,8,3,8,8,3,8,8,3,8,8,3,8,8,3,8,8,3,8,8,3],
			 [3,8,8,3,8,8,3,8,8,3,8,8,3,8,8,3,8,8,3,8,8,3,8,8,3,8,8,3,8,8,3,8,8,3,8,8,3,8,8,3,8,8,3,8,8,3,8,8,3,8,8,3,8,8,3,8,8,3,8,8,3,8,8,3,8,8,3,8,8,3,8,8,3,8,8,3,8,8,3,8,8,3,8,8,3,8,8,3,8,8,3,8,8,3,8,8,3,8,8,3],
			 [3,3,3,3,3,3,3,3,3,3,3,3,3,3,3,3,3,3,3,3,3,3,3,3,3,3,3,3,3,3,3,3,3,3,3,3,3,3,3,3,3,3,3,3,3,3,3,3,3,3,3,3,3,3,3,3,3,3,3,3,3,3,3,3,3,3,3,3,3,3,3,3,3,3,3,3,3,3,3,3,3,3,3,3,3,3,3,3,3,3,3,3,3,3,3,3,3,3,3,3],
			 [3,8,8,3,8,8,3,8,8,3,8,8,3,8,8,3,8,8,3,8,8,3,8,8,3,8,8,3,8,8,3,8,8,3,8,8,3,8,8,3,8,8,3,8,8,3,8,8,3,8,8,3,8,8,3,8,8,3,8,8,3,8,8,3,8,8,3,8,8,3,8,8,3,8,8,3,8,8,3,8,8,3,8,8,3,8,8,3,8,8,3,8,8,3,8,8,3,8,8,3],
			 [3,8,8,42,8,8,3,8,8,3,8,8,3,8,8,3,8,8,3,8,8,3,8,8,3,8,8,3,8,8,3,8,8,3,8,8,3,8,8,3,8,8,3,8,8,3,8,8,3,8,8,3,8,8,3,8,8,3,8,8,3,8,8,3,8,8,3,8,8,3,8,8,3,8,8,3,8,8,3,8,8,3,8,8,3,8,8,3,8,8,3,8,8,3,8,8,3,8,8,3],
			 [3,3,3,3,3,3,3,3,3,3,3,3,3,3,3,3,3,3,3,3,3,3,3,3,3,3,3,3,3,3,3,3,3,3,3,3,3,3,3,3,3,3,3,3,3,3,3,3,3,3,3,3,3,3,3,3,3,3,3,3,3,3,3,3,3,3,3,3,3,3,3,3,3,3,3,3,3,3,3,3,3,3,3,3,3,3,3,3,3,3,3,3,3,3,3,3,3,3,3,3],
			 [3,8,8,3,8,8,3,8,8,3,8,8,3,8,8,3,8,8,3,8,8,3,8,8,3,8,8,3,8,8,3,8,8,3,8,8,3,8,8,3,8,8,3,8,8,3,8,8,3,8,8,3,8,8,3,8,8,3,8,8,3,8,8,3,8,8,3,8,8,3,8,8,3,8,8,3,8,8,3,8,8,3,8,8,3,8,8,3,8,8,3,8,8,3,8,8,3,8,8,3],
			 [3,8,8,3,8,8,3,8,8,3,8,8,3,8,8,3,8,8,3,8,8,3,8,8,3,8,8,3,8,8,3,8,8,3,8,8,3,8,8,3,8,8,3,8,8,3,8,8,3,8,8,3,8,8,3,8,8,3,8,8,3,8,8,3,8,8,3,8,8,3,8,8,3,8,8,3,8,8,3,8,8,3,8,8,3,8,8,3,8,8,3,8,8,3,8,8,3,8,8,3],
			 [3,3,3,3,3,3,3,3,3,3,3,3,3,3,3,3,3,3,3,3,3,3,3,3,3,3,3,3,3,3,3,3,3,3,3,3,3,3,3,3,3,3,3,3,3,3,3,3,3,3,3,3,3,3,3,3,3,3,3,3,3,3,3,3,3,3,3,3,3,3,3,3,3,3,3,3,3,3,3,3,3,3,3,3,3,3,3,3,3,3,3,3,3,3,3,3,3,3,3,3],
			 [3,8,8,3,8,8,3,8,8,3,8,8,3,8,8,3,8,8,3,8,8,3,8,8,3,8,8,3,8,8,3,8,8,3,8,8,3,8,8,3,8,8,3,8,8,3,8,8,3,8,8,3,8,8,3,8,8,3,8,8,3,8,8,3,8,8,3,8,8,3,8,8,3,8,8,3,8,8,3,8,8,3,8,8,3,8,8,3,8,8,3,8,8,3,8,8,3,8,8,3],
			 [3,8,8,3,8,8,3,8,8,3,8,8,3,8,8,3,8,8,3,8,8,3,8,8,3,8,8,3,8,8,3,8,8,3,8,8,3,8,8,3,8,8,3,8,8,3,8,8,3,8,8,3,8,8,3,8,8,3,8,8,3,8,8,3,8,8,3,8,8,3,8,8,3,8,8,3,8,8,3,8,8,3,8,8,3,8,8,3,8,8,3,8,8,3,8,8,3,8,8,3],
			 [3,3,3,3,3,3,3,3,3,3,3,3,3,3,3,3,3,3,3,3,3,3,3,3,3,3,3,3,3,3,3,3,3,3,3,3,3,3,3,3,3,3,3,3,3,3,3,3,3,3,3,3,3,3,3,3,3,3,3,3,3,3,3,3,3,3,3,3,3,3,3,3,3,3,3,3,3,3,3,3,3,3,3,3,3,3,3,3,3,3,3,3,3,3,3,3,3,3,3,3],
			 [3,8,8,3,8,8,3,8,8,3,8,8,3,8,8,3,8,8,3,8,8,3,8,8,3,8,8,3,8,8,3,8,8,3,8,8,3,8,8,3,8,8,3,8,8,3,8,8,3,8,8,3,8,8,3,8,8,3,8,8,3,8,8,3,8,8,3,8,8,3,8,8,3,8,8,3,8,8,3,8,8,3,8,8,3,8,8,3,8,8,3,8,8,3,8,8,3,8,8,3],
			 [3,8,8,3,8,8,3,8,8,3,8,8,3,8,8,3,8,8,3,8,8,3,8,8,3,8,8,3,8,8,3,8,8,3,8,8,3,8,8,3,8,8,3,8,8,3,8,8,3,8,8,3,8,8,3,8,8,3,8,8,3,8,8,3,8,8,3,8,8,3,8,8,3,8,8,3,8,8,3,8,8,3,8,8,3,8,8,3,8,8,3,8,8,3,8,8,3,8,8,3],
			 [3,3,3,3,3,3,3,3,3,3,3,3,3,3,3,3,3,3,3,3,3,3,3,3,3,3,3,3,3,3,3,3,3,3,3,3,3,3,3,3,3,3,3,3,3,3,3,3,3,3,3,3,3,3,3,3,3,3,3,3,3,3,3,3,3,3,3,3,3,3,3,3,3,3,3,3,3,3,3,3,3,3,3,3,3,3,3,3,3,3,3,3,3,3,3,3,3,3,3,3],
			 [3,8,8,3,8,8,3,8,8,3,8,8,3,8,8,3,8,8,3,8,8,3,8,8,3,8,8,3,8,8,3,8,8,3,8,8,3,8,8,3,8,8,3,8,8,3,8,8,3,8,8,3,8,8,3,8,8,3,8,8,3,8,8,3,8,8,3,8,8,3,8,8,3,8,8,3,8,8,3,8,8,3,8,8,3,8,8,3,8,8,3,8,8,3,8,8,3,8,8,3],
			 [3,8,8,3,8,8,3,8,8,3,8,8,3,8,8,3,8,8,3,8,8,3,8,8,3,8,8,3,8,8,3,8,8,3,8,8,3,8,8,3,8,8,3,8,8,3,8,8,3,8,8,3,8,8,3,8,8,3,8,8,3,8,8,3,8,8,3,8,8,3,8,8,3,8,8,3,8,8,3,8,8,3,8,8,3,8,8,3,8,8,3,8,8,3,8,8,3,8,8,3],
			 [3,3,3,3,3,3,3,3,3,3,3,3,3,3,3,3,3,3,3,3,3,3,3,3,3,3,3,3,3,3,3,3,3,3,3,3,3,3,3,3,3,3,3,3,3,3,3,3,3,3,3,3,3,3,3,3,3,3,3,3,3,3,3,3,3,3,3,3,3,3,3,3,3,3,3,3,3,3,3,3,3,3,3,3,3,3,3,3,3,3,3,3,3,3,3,3,3,3,3,3],
			 [3,8,8,3,8,8,3,8,8,3,8,8,3,8,8,3,8,8,3,8,8,3,8,8,3,8,8,3,8,8,3,8,8,3,8,8,3,8,8,3,8,8,3,8,8,3,8,8,3,8,8,3,8,8,3,8,8,3,8,8,3,8,8,3,8,8,3,8,8,3,8,8,3,8,8,3,8,8,3,8,8,3,8,8,3,8,8,3,8,8,3,8,8,3,8,8,3,8,8,3],
			 [3,8,8,3,8,8,3,8,8,3,8,8,3,8,8,3,8,8,3,8,8,3,8,8,3,8,8,3,8,8,3,8,8,3,8,8,3,8,8,3,8,8,3,8,8,3,8,8,3,8,8,3,8,8,3,8,8,3,8,8,3,8,8,3,8,8,3,8,8,3,8,8,3,8,8,3,8,8,3,8,8,3,8,8,3,8,8,3,8,8,3,8,8,3,8,8,3,8,8,3],
			 [3,3,3,3,3,3,3,3,3,3,3,3,3,3,3,3,3,3,3,3,3,3,3,3,3,3,3,3,3,3,3,3,3,3,3,3,3,3,3,3,3,3,3,3,3,3,3,3,3,3,3,3,3,3,3,3,3,3,3,3,3,3,3,3,3,3,3,3,3,3,3,3,3,3,3,3,3,3,3,3,3,3,3,3,3,3,3,3,3,3,3,3,3,3,3,3,3,3,3,3],
			 [3,8,8,3,8,8,3,8,8,3,8,8,3,8,8,3,8,8,3,8,8,3,8,8,3,8,8,3,8,8,3,8,8,3,8,8,3,8,8,3,8,8,3,8,8,3,8,8,3,8,8,3,8,8,3,8,8,3,8,8,3,8,8,3,8,8,3,8,8,3,8,8,3,8,8,3,8,8,3,8,8,3,8,8,3,8,8,3,8,8,3,8,8,3,8,8,3,8,8,3],
			 [3,8,8,3,8,8,3,8,8,3,8,8,3,8,8,3,8,8,3,8,8,3,8,8,3,8,8,3,8,8,3,8,8,3,8,8,3,8,8,3,8,8,3,8,8,3,8,8,3,8,8,3,8,8,3,8,8,3,8,8,3,8,8,3,8,8,3,8,8,3,8,8,3,8,8,3,8,8,3,8,8,3,8,8,3,8,8,3,8,8,3,8,8,3,8,8,3,8,8,3],
			 [3,3,3,3,3,3,3,3,3,3,3,3,3,3,3,3,3,3,3,3,3,3,3,3,3,3,3,3,3,3,3,3,3,3,3,3,3,3,3,3,3,3,3,3,3,3,3,3,3,3,3,3,3,3,3,3,3,3,3,3,3,3,3,3,3,3,3,3,3,3,3,3,3,3,3,3,3,3,3,3,3,3,3,3,3,3,3,3,3,3,3,3,3,3,3,3,3,3,3,3],
			 [3,8,8,3,8,8,3,8,8,3,8,8,3,8,8,3,8,8,3,8,8,3,8,8,3,8,8,3,8,8,3,8,8,3,8,8,3,8,8,3,8,8,3,8,8,3,8,8,3,8,8,3,8,8,3,8,8,3,8,8,3,8,8,3,8,8,3,8,8,3,8,8,3,8,8,3,8,8,3,8,8,3,8,8,3,8,8,3,8,8,3,8,8,3,8,8,3,8,8,3],
			 [3,8,8,3,8,8,3,8,8,3,8,8,3,8,8,3,8,8,3,8,8,3,8,8,3,8,8,3,8,8,3,8,8,3,8,8,3,8,8,3,8,8,3,8,8,3,8,8,3,8,8,3,8,8,3,8,8,3,8,8,3,8,8,3,8,8,3,8,8,3,8,8,3,8,8,3,8,8,3,8,8,3,8,8,3,8,8,3,8,8,3,8,8,3,8,8,3,8,8,3],
			 [3,3,3,3,3,3,3,3,3,3,3,3,3,3,3,3,3,3,3,3,3,3,3,3,3,3,3,3,3,3,3,3,3,3,3,3,3,3,3,3,3,3,3,3,3,3,3,3,3,3,3,3,3,3,3,3,3,3,3,3,3,3,3,3,3,3,3,3,3,3,3,3,3,3,3,3,3,3,3,3,3,3,3,3,3,3,3,3,3,3,3,3,3,3,3,3,3,3,3,3],
			 [3,8,8,3,8,8,3,8,8,3,8,8,3,8,8,3,8,8,3,8,8,3,8,8,3,8,8,3,8,8,3,8,8,3,8,8,3,8,8,3,8,8,3,8,8,3,8,8,3,8,8,3,8,8,3,8,8,3,8,8,3,8,8,3,8,8,3,8,8,3,8,8,3,8,8,3,8,8,3,8,8,3,8,8,3,8,8,3,8,8,3,8,8,3,8,8,3,8,8,3],
			 [3,8,8,3,8,8,3,8,8,3,8,8,3,8,8,3,8,8,3,8,8,3,8,8,3,8,8,3,8,8,3,8,8,3,8,8,3,8,8,3,8,8,3,8,8,3,8,8,3,8,8,3,8,8,3,8,8,3,8,8,3,8,8,3,8,8,3,8,8,3,8,8,3,8,8,3,8,8,3,8,8,3,8,8,3,8,8,3,8,8,3,8,8,3,8,8,3,8,8,3],
			 [3,3,3,3,3,3,3,3,3,3,3,3,3,3,3,3,3,3,3,3,3,3,3,3,3,3,3,3,3,3,3,3,3,3,3,3,3,3,3,3,3,3,3,3,3,3,3,3,3,3,3,3,3,3,3,3,3,3,3,3,3,3,3,3,3,3,3,3,3,3,3,3,3,3,3,3,3,3,3,3,3,3,3,3,3,3,3,3,3,3,3,3,3,3,3,3,3,3,3,3]
			 ],
	"adjacency": [null,null,null,null],
	"tileType": {"walk": [0,1,6,7,8,9,10,11,15,16,17,21,22,23,45,47]},
	"entities":
	[
	],
	"warps":
	{
	}
}