{
	"tileset": "tiles",
	"grid": [[ 3, 3, 3, 3, 3, 3, 3, 3, 3, 3, 3, 3, 3, 3, 3, 3, 3, 3, 3, 3, 3, 3, 3, 3, 3, 3, 3, 3, 3, 3, 3, 3, 3, 3, 3, 3, 3, 3, 3, 3, 3, 3, 3, 3, 3, 3, 3, 3, 3, 3, 3, 3, 3, 3, 3, 3, 3, 3, 3, 3, 3, 3, 3, 3, 3, 3, 3, 3, 3, 3, 3, 3, 3, 3, 3, 3, 3, 3, 3, 3, 3, 3, 3, 3, 3, 3, 3, 3, 3, 3, 3, 3, 3, 3, 3, 3, 3, 3, 3,3],
			 [ 3, 8, 8, 3, 8, 8, 3, 8, 8, 3, 8, 8, 3, 8, 8, 3, 8, 8, 3, 8, 8, 3, 8, 8, 3, 8, 8, 3, 8, 8, 3, 8, 8, 3, 8, 8, 3, 8, 8, 3, 8, 8, 3, 8, 8, 3, 8, 8, 3, 8, 8, 3, 8, 8, 3, 8, 8, 3, 8, 8, 3, 8, 8, 3, 8, 8, 3, 8, 8, 3, 8, 8, 3, 8, 8, 3, 8, 8, 3, 8, 8, 3, 8, 8, 3, 8, 8, 3, 8, 8, 3, 8, 8, 3, 8, 8, 3, 8, 8,3],
			 [ 3, 8, 8, 3, 8, 8, 3, 8, 8, 3, 8, 8, 3, 8, 8, 3, 8, 8, 3, 8, 8, 3, 8, 8, 3, 8, 8, 3, 8, 8, 3, 8, 8, 3, 8, 8, 3, 8, 8, 3, 8, 8, 3, 8, 8, 3, 8, 8, 3, 8, 8, 3, 8, 8, 3, 8, 8, 3, 8, 8, 3, 8, 8, 3, 8, 8, 3, 8, 8, 3, 8, 8, 3, 8, 8, 3, 8, 8, 3, 8, 8, 3, 8, 8, 3, 8, 8, 3, 8, 8, 3, 8, 8, 3, 8, 8, 3, 8, 8,3],
			 [ 3, 3, 3, 3, 3, 3, 3, 3, 3, 3, 3, 3, 3, 3, 3, 3, 3, 3, 3, 3, 3, 3, 3, 3, 3, 3, 3, 3, 3, 3, 3, 3, 3, 3, 3, 3, 3, 3, 3, 3, 3, 3, 3, 3, 3, 3, 3, 3, 3, 3, 3, 3, 3, 3, 3, 3, 3, 3, 3, 3, 3, 3, 3, 3, 3, 3, 3, 3, 3, 3, 3, 3, 3, 3, 3, 3, 3, 3, 3, 3, 3, 3, 3, 3, 3, 3, 3, 3, 3, 3, 3, 3, 3, 3, 3, 3, 3, 3, 3,3],
			 [ 3, 8, 8, 3, 8, 8, 3, 8, 8, 3, 8, 8, 3, 8, 8, 3, 8, 8, 3, 8, 8, 3, 8, 8, 3, 8, 8, 3, 8, 8, 3, 8, 8, 3, 8, 8, 3, 8, 8, 3, 8, 8, 3, 8, 8, 3, 8, 8, 3, 8, 8, 3, 8, 8, 3, 8, 8, 3, 8, 8, 3, 8, 8, 3, 8, 8, 3, 8, 8, 3, 8, 8, 3, 8, 8, 3, 8, 8, 3, 8, 8, 3, 8, 8, 3, 8, 8, 3, 8, 8, 3, 8, 8, 3, 8, 8, 3, 8, 8,3],
			 [ 3, 8, 8, 3, 8, 8, 3, 8, 8, 3, 8, 8, 3, 8, 8, 3, 8, 8, 3, 8, 8, 3, 8, 8, 3, 8, 8, 3, 8, 8, 3, 8, 8, 3, 8, 8, 3, 8, 8, 3, 8, 8, 3, 8, 8, 3, 8, 8, 3, 8, 8, 3, 8, 8, 3, 8, 8, 3, 8, 8, 3, 8, 8, 3, 8, 8, 3, 8, 8, 3, 8, 8, 3, 8, 8, 3, 8, 8, 3, 8, 8, 3, 8, 8, 3, 8, 8, 3, 8, 8, 3, 8, 8, 3, 8, 8, 3, 8, 8,3],
			 [ 3, 3, 3, 3, 3, 3, 3, 3, 3, 3, 3, 3, 3, 3, 3, 3, 3, 3, 3, 3, 3, 3, 3, 3, 3, 3, 3, 3, 3, 3, 3, 3, 3, 3, 3, 3, 3, 3, 3, 3, 3, 3, 3, 3, 3, 3, 3, 3, 3, 3, 3, 3, 3, 3, 3, 3, 3, 3, 3, 3, 3, 3, 3, 3, 3, 3, 3, 3, 3, 3, 3, 3, 3, 3, 3, 3, 3, 3, 3, 3, 3, 3, 3, 3, 3, 3, 3, 3, 3, 3, 3, 3, 3, 3, 3, 3, 3, 3, 3,3],
			 [ 3, 8, 8, 3, 8, 8, 3, 8, 8, 8, 8, 8, 3, 8, 8, 3, 8, 8, 3, 8, 8, 3, 8, 8, 3, 8, 8, 3, 8, 8, 3, 8, 8, 3, 8, 8, 3, 8, 8, 3, 8, 8, 3, 8, 8, 3, 8, 8, 3, 8, 8, 3, 8, 8, 3, 8, 8, 3, 8, 8, 3, 8, 8, 3, 8, 8, 3, 8, 8, 3, 8, 8, 3, 8, 8, 3, 8, 8, 3, 8, 8, 3, 8, 8, 3, 8, 8, 3, 8, 8, 3, 8, 8, 3, 8, 8, 3, 8, 8,3],
			 [ 3, 8, 8, 3, 8, 8, 3, 8, 8, 8, 8, 8, 3, 8, 8, 8, 8, 8, 8, 8, 8, 8, 8, 8, 8, 8, 8, 3, 8, 8, 3, 8, 8, 3, 8, 8, 3, 8, 8, 3, 8, 8, 3, 8, 8, 3, 8, 8, 3, 8, 8, 3, 8, 8, 3, 8, 8, 3, 8, 8, 3, 8, 8, 3, 8, 8, 3, 8, 8, 3, 8, 8, 3, 8, 8, 3, 8, 8, 3, 8, 8, 3, 8, 8, 3, 8, 8, 3, 8, 8, 3, 8, 8, 3, 8, 8, 3, 8, 8,3],
			 [ 3, 3, 3, 3, 3, 3, 3, 8, 8, 3, 8, 8, 3, 3, 3, 8, 3, 3, 3, 3, 3, 3, 3, 3, 3, 3, 8, 3, 3, 3, 3, 3, 3, 3, 3, 3, 3, 3, 3, 3, 3, 3, 3, 3, 3, 3, 3, 3, 3, 3, 3, 3, 3, 3, 3, 3, 3, 3, 3, 3, 3, 3, 3, 3, 3, 3, 3, 3, 3, 3, 3, 3, 3, 3, 3, 3, 3, 3, 3, 3, 3, 3, 3, 3, 3, 3, 3, 3, 3, 3, 3, 3, 3, 3, 3, 3, 3, 3, 3,3],
			 [ 3, 8, 8, 3, 8, 8, 3, 8, 8, 3, 8, 8, 3, 8, 8, 8, 8, 8, 3, 8, 8, 3, 8, 8, 3, 8, 8, 3, 8, 8, 3, 8, 8, 3, 8, 8, 3, 8, 8, 3, 8, 8, 3, 8, 8, 3, 8, 8, 3, 8, 8, 3, 8, 8, 3, 8, 8, 3, 8, 8, 3, 8, 8, 3, 8, 8, 3, 8, 8, 3, 8, 8, 3, 8, 8, 3, 8, 8, 3, 8, 8, 3, 8, 8, 3, 8, 8, 3, 8, 8, 3, 8, 8, 3, 8, 8, 3, 8, 8,3],
			 [ 3, 8, 8, 3, 8, 8, 3, 8, 8, 3, 8, 8, 3, 8, 8, 3, 8, 8, 3, 8, 8, 3, 8, 8, 3, 8, 8, 8, 8, 8, 3, 8, 8, 3, 8, 8, 3, 8, 8, 3, 8, 8, 3, 8, 8, 3, 8, 8, 3, 8, 8, 3, 8, 8, 3, 8, 8, 3, 8, 8, 3, 8, 8, 3, 8, 8, 3, 8, 8, 3, 8, 8, 3, 8, 8, 3, 8, 8, 3, 8, 8, 3, 8, 8, 3, 8, 8, 3, 8, 8, 3, 8, 8, 3, 8, 8, 3, 8, 8,3],
			 [12,13,13,13,14, 3, 3, 8, 8, 3, 8, 8, 3, 3, 3, 3, 3, 8, 3, 3, 3, 3, 3, 3, 3, 3, 3, 3, 3, 8, 3, 3, 3, 3, 3, 3, 3, 3, 3, 3, 3, 3, 3, 3, 3, 3, 3, 3, 3, 3, 3, 3, 3, 3, 3, 3, 3, 3, 3, 3, 3, 3, 3, 3, 3, 3, 3, 3, 3, 3, 3, 3, 3, 3, 3, 3, 3, 3, 3, 3, 3, 3, 3, 3, 3, 3, 3, 3, 3, 3, 3, 3, 3, 3, 3, 3, 3, 3, 3,3],
			 [18,19,19,19,20, 3, 3, 8, 8, 3, 8, 8, 8, 8, 8, 8, 8, 8, 3, 8, 8, 3, 8, 8, 3, 8, 8, 3, 8, 8, 3, 8, 8, 3, 8, 8, 3, 8, 8, 3, 8, 8, 3, 8, 8, 3, 8, 8, 3, 8, 8, 3, 8, 8, 3, 8, 8, 3, 8, 8, 3, 8, 8, 3, 8, 8, 3, 8, 8, 3, 8, 8, 3, 8, 8, 3, 8, 8, 3, 8, 8, 3, 8, 8, 3, 8, 8, 3, 8, 8, 3, 8, 8, 3, 8, 8, 3, 8, 8,3],
			 [24,25,25,25,26, 3, 3, 8, 8, 3, 8, 8, 8, 8, 8, 3, 8, 8, 3, 8, 8, 3, 8, 8, 3, 8, 8, 3, 8, 8, 3, 8, 8, 3, 8, 8, 3, 8, 8, 3, 8, 8, 3, 8, 8, 3, 8, 8, 3, 8, 8, 3, 8, 8, 3, 8, 8, 3, 8, 8, 3, 8, 8, 3, 8, 8, 3, 8, 8, 3, 8, 8, 3, 8, 8, 3, 8, 8, 3, 8, 8, 3, 8, 8, 3, 8, 8, 3, 8, 8, 3, 8, 8, 3, 8, 8, 3, 8, 8,3],
			 [30,31,31,31,35, 3, 3, 8, 8, 3, 3, 3, 3, 8, 8, 3, 3, 3, 3, 3, 3, 3, 3, 3, 3, 3, 3, 3, 3, 8, 3, 3, 3, 3, 3, 3, 3, 3, 3, 3, 3, 3, 3, 3, 3, 3, 3, 3, 3, 3, 3, 3, 3, 3, 3, 3, 3, 3, 3, 3, 3, 3, 3, 3, 3, 3, 3, 3, 3, 3, 3, 3, 3, 3, 3, 3, 3, 3, 3, 3, 3, 3, 3, 3, 3, 3, 3, 3, 3, 3, 3, 3, 3, 3, 3, 3, 3, 3, 3,3],
			 [30,31,32,33,35, 3, 3, 8, 8, 8, 8, 8, 3, 8, 8, 3, 8, 8, 3, 8, 8, 3, 8, 8, 3, 8, 8, 3, 8, 8, 3, 8, 8, 3, 8, 8, 3, 8, 8, 3, 8, 8, 3, 8, 8, 3, 8, 8, 3, 8, 8, 3, 8, 8, 3, 8, 8, 3, 8, 8, 3, 8, 8, 3, 8, 8, 3, 8, 8, 3, 8, 8, 3, 8, 8, 3, 8, 8, 3, 8, 8, 3, 8, 8, 3, 8, 8, 3, 8, 8, 3, 8, 8, 3, 8, 8, 3, 8, 8,3],
			 [30,31,31,31,35, 3, 3, 8, 8, 8, 8, 8, 3, 8, 8, 3, 8, 8, 3, 8, 8, 3, 8, 8, 3, 8, 8, 3, 8, 8, 8, 8, 8, 3, 8, 8, 3, 8, 8, 3, 8, 8, 3, 8, 8, 3, 8, 8, 3, 8, 8, 3, 8, 8, 3, 8, 8, 3, 8, 8, 3, 8, 8, 3, 8, 8, 3, 8, 8, 3, 8, 8, 3, 8, 8, 3, 8, 8, 3, 8, 8, 3, 8, 8, 3, 8, 8, 3, 8, 8, 3, 8, 8, 3, 8, 8, 3, 8, 8,3],
			 [36,37,37,42,41, 3, 3, 8, 8, 3, 8, 8, 3, 8, 8, 3, 3, 3, 3, 3, 3, 3, 3, 3, 3, 3, 3, 3, 3, 3, 3, 3, 8, 3, 3, 3, 3, 3, 3, 3, 3, 3, 3, 3, 3, 3, 3, 3, 3, 3, 3, 3, 3, 3, 3, 3, 3, 3, 3, 3, 3, 3, 3, 3, 3, 3, 3, 3, 3, 3, 3, 3, 3, 3, 3, 3, 3, 3, 3, 3, 3, 3, 3, 3, 3, 3, 3, 3, 3, 3, 3, 3, 3, 3, 3, 3, 3, 3, 3,3],
			 [ 3, 8, 8, 8, 8, 8, 8, 8, 8, 3, 8, 8, 3, 8, 8, 3, 8, 8, 3, 8, 8, 3, 8, 8, 3, 8, 8, 3, 8, 8, 3, 8, 8, 3, 8, 8, 3, 8, 8, 3, 8, 8, 3, 8, 8, 3, 8, 8, 3, 8, 8, 3, 8, 8, 3, 8, 8, 3, 8, 8, 3, 8, 8, 3, 8, 8, 3, 8, 8, 3, 8, 8, 3, 8, 8, 3, 8, 8, 3, 8, 8, 3, 8, 8, 3, 8, 8, 3, 8, 8, 3, 8, 8, 3, 8, 8, 3, 8, 8,3],
			 [ 3, 8, 8, 8, 8, 8, 8, 8, 8, 3, 8, 8, 3, 8, 8, 3, 8, 8, 3, 8, 8, 3, 8, 8, 3, 8, 8, 3, 8, 8, 8, 8, 8, 3, 8, 8, 3, 8, 8, 3, 8, 8, 3, 8, 8, 3, 8, 8, 3, 8, 8, 3, 8, 8, 3, 8, 8, 3, 8, 8, 3, 8, 8, 3, 8, 8, 3, 8, 8, 3, 8, 8, 3, 8, 8, 3, 8, 8, 3, 8, 8, 3, 8, 8, 3, 8, 8, 3, 8, 8, 3, 8, 8, 3, 8, 8, 3, 8, 8,3],
			 [ 3, 8, 8, 8, 8, 8, 8, 8, 8, 3, 3, 3, 3, 8, 8, 3, 3, 3, 3, 3, 3, 3, 3, 3, 3, 3, 3, 3, 8, 3, 3, 3, 3, 3, 3, 3, 3, 3, 3, 3, 3, 3, 3, 3, 3, 3, 3, 3, 3, 3, 3, 3, 3, 3, 3, 3, 3, 3, 3, 3, 3, 3, 3, 3, 3, 3, 3, 3, 3, 3, 3, 3, 3, 3, 3, 3, 3, 3, 3, 3, 3, 3, 3, 3, 3, 3, 3, 3, 3, 3, 3, 3, 3, 3, 3, 3, 3, 3, 3,3],
			 [ 3, 8, 8, 8, 8, 8, 8, 8, 8, 8, 8, 8, 8, 8, 8, 3, 8, 8, 3, 8, 8, 3, 8, 8, 3, 8, 8, 3, 8, 8, 3, 8, 8, 3, 8, 8, 3, 8, 8, 3, 8, 8, 3, 8, 8, 3, 8, 8, 3, 8, 8, 3, 8, 8, 3, 8, 8, 3, 8, 8, 3, 8, 8, 3, 8, 8, 3, 8, 8, 3, 8, 8, 3, 8, 8, 3, 8, 8, 3, 8, 8, 3, 8, 8, 3, 8, 8, 3, 8, 8, 3, 8, 8, 3, 8, 8, 3, 8, 8,3],
			 [ 3, 8, 8, 8, 8, 8, 8, 8, 8, 8, 8, 8, 8, 8, 8, 3, 8, 8, 3, 8, 8, 3, 8, 8, 3, 8, 8, 3, 8, 8, 3, 8, 8, 3, 8, 8, 3, 8, 8, 3, 8, 8, 3, 8, 8, 3, 8, 8, 3, 8, 8, 3, 8, 8, 3, 8, 8, 3, 8, 8, 3, 8, 8, 3, 8, 8, 3, 8, 8, 3, 8, 8, 3, 8, 8, 3, 8, 8, 3, 8, 8, 3, 8, 8, 3, 8, 8, 3, 8, 8, 3, 8, 8, 3, 8, 8, 3, 8, 8,3],
			 [ 3, 8, 8, 8, 8, 8, 8, 8, 8, 3, 3, 3, 3, 3, 3, 3, 3, 3, 3, 3, 3, 3, 3, 3, 3, 3, 3, 3, 3, 8, 3, 3, 3, 3, 3, 3, 3, 3, 3, 3, 3, 3, 3, 3, 3, 3, 3, 3, 3, 3, 3, 3, 3, 3, 3, 3, 3, 3, 3, 3, 3, 3, 3, 3, 3, 3, 3, 3, 3, 3, 3, 3, 3, 3, 3, 3, 3, 3, 3, 3, 3, 3, 3, 3, 3, 3, 3, 3, 3, 3, 3, 3, 3, 3, 3, 3, 3, 3, 3,3],
			 [ 3, 8, 8, 8, 8, 8, 8, 8, 8, 3, 8, 8, 3, 8, 8, 3, 8, 8, 3, 8, 8, 3, 8, 8, 3, 8, 8, 3, 8, 8, 3, 8, 8, 3, 8, 8, 3, 8, 8, 3, 8, 8, 3, 8, 8, 3, 8, 8, 3, 8, 8, 3, 8, 8, 3, 8, 8, 3, 8, 8, 3, 8, 8, 3, 8, 8, 3, 8, 8, 3, 8, 8, 3, 8, 8, 3, 8, 8, 3, 8, 8, 3, 8, 8, 3, 8, 8, 3, 8, 8, 3, 8, 8, 3, 8, 8, 3, 8, 8,3],
			 [ 3, 8, 8, 8, 8, 8, 8, 8, 8, 3, 8, 8, 3, 8, 8, 3, 8, 8, 3, 8, 8, 3, 8, 8, 3, 8, 8, 3, 8, 8, 3, 8, 8, 3, 8, 8, 3, 8, 8, 3, 8, 8, 3, 8, 8, 3, 8, 8, 3, 8, 8, 3, 8, 8, 3, 8, 8, 3, 8, 8, 3, 8, 8, 3, 8, 8, 3, 8, 8, 3, 8, 8, 3, 8, 8, 3, 8, 8, 3, 8, 8, 3, 8, 8, 3, 8, 8, 3, 8, 8, 3, 8, 8, 3, 8, 8, 3, 8, 8,3],
			 [ 3, 3, 3, 3, 3, 3, 3, 8, 8, 3, 3, 3, 3, 3, 3, 3, 3, 3, 3, 3, 3, 3, 3, 3, 3, 3, 3, 3, 3, 8, 3, 3, 3, 3, 3, 3, 3, 3, 3, 3, 3, 3, 3, 3, 3, 3, 3, 3, 3, 3, 3, 3, 3, 3, 3, 3, 3, 3, 3, 3, 3, 3, 3, 3, 3, 3, 3, 3, 3, 3, 3, 3, 3, 3, 3, 3, 3, 3, 3, 3, 3, 3, 3, 3, 3, 3, 3, 3, 3, 3, 3, 3, 3, 3, 3, 3, 3, 3, 3,3],
			 [ 3, 8, 8, 3, 8, 8, 3, 8, 8, 3, 8, 8, 3, 8, 8, 3, 8, 8, 3, 8, 8, 3, 8, 8, 3, 8, 8, 3, 8, 8, 3, 8, 8, 3, 8, 8, 3, 8, 8, 3, 8, 8, 3, 8, 8, 3, 8, 8, 3, 8, 8, 3, 8, 8, 3, 8, 8, 3, 8, 8, 3, 8, 8, 3, 8, 8, 3, 8, 8, 3, 8, 8, 3, 8, 8, 3, 8, 8, 3, 8, 8, 3, 8, 8, 3, 8, 8, 3, 8, 8, 3, 8, 8, 3, 8, 8, 3, 8, 8,3],
			 [ 3, 8, 8, 3, 8, 8, 3, 8, 8, 3, 8, 8, 3, 8, 8, 3, 8, 8, 3, 8, 8, 3, 8, 8, 3, 8, 8, 3, 8, 8, 3, 8, 8, 3, 8, 8, 3, 8, 8, 3, 8, 8, 3, 8, 8, 3, 8, 8, 3, 8, 8, 3, 8, 8, 3, 8, 8, 3, 8, 8, 3, 8, 8, 3, 8, 8, 3, 8, 8, 3, 8, 8, 3, 8, 8, 3, 8, 8, 3, 8, 8, 3, 8, 8, 3, 8, 8, 3, 8, 8, 3, 8, 8, 3, 8, 8, 3, 8, 8,3],
			 [ 3, 3, 3, 3, 3, 3, 3, 3, 3, 3, 3, 3, 3, 3, 3, 3, 3, 3, 3, 3, 3, 3, 3, 3, 3, 3, 3, 3, 3, 8, 3, 3, 3, 3, 3, 3, 3, 3, 3, 3, 3, 3, 3, 3, 3, 3, 3, 3, 3, 3, 3, 3, 3, 3, 3, 3, 3, 3, 3, 3, 3, 3, 3, 3, 3, 3, 3, 3, 3, 3, 3, 3, 3, 3, 3, 3, 3, 3, 3, 3, 3, 3, 3, 3, 3, 3, 3, 3, 3, 3, 3, 3, 3, 3, 3, 3, 3, 3, 3,3],
			 [ 3, 8, 8, 3, 8, 8, 3, 8, 8, 3, 8, 8, 3, 8, 8, 3, 8, 8, 3, 8, 8, 3, 8, 8, 3, 8, 8, 3, 8, 8, 3, 8, 8, 3, 8, 8, 3, 8, 8, 3, 8, 8, 3, 8, 8, 3, 8, 8, 3, 8, 8, 3, 8, 8, 3, 8, 8, 3, 8, 8, 3, 8, 8, 3, 8, 8, 3, 8, 8, 3, 8, 8, 3, 8, 8, 3, 8, 8, 3, 8, 8, 3, 8, 8, 3, 8, 8, 3, 8, 8, 3, 8, 8, 3, 8, 8, 3, 8, 8,3],
			 [ 3, 8, 8, 3, 8, 8, 3, 8, 8, 3, 8, 8, 3, 8, 8, 3, 8, 8, 3, 8, 8, 3, 8, 8, 3, 8, 8, 3, 8, 8, 8, 8, 8, 8, 8, 8, 3, 8, 8, 3, 8, 8, 3, 8, 8, 3, 8, 8, 3, 8, 8, 3, 8, 8, 3, 8, 8, 3, 8, 8, 3, 8, 8, 3, 8, 8, 3, 8, 8, 3, 8, 8, 3, 8, 8, 3, 8, 8, 3, 8, 8, 3, 8, 8, 3, 8, 8, 3, 8, 8, 3, 8, 8, 3, 8, 8, 3, 8, 8,3],
			 [ 3, 3, 3, 3, 3, 3, 3, 3, 3, 3, 3, 3, 3, 3, 3, 3, 3, 3, 3, 3, 3, 3, 3, 3, 3, 3, 3, 3, 3, 3, 3, 3, 3, 3, 8, 3, 3, 3, 3, 3, 3, 3, 3, 3, 3, 3, 3, 3, 3, 3, 3, 3, 3, 3, 3, 3, 3, 3, 3, 3, 3, 3, 3, 3, 3, 3, 3, 3, 3, 3, 3, 3, 3, 3, 3, 3, 3, 3, 3, 3, 3, 3, 3, 3, 3, 3, 3, 3, 3, 3, 3, 3, 3, 3, 3, 3, 3, 3, 3,3],
			 [ 3, 8, 8, 3, 8, 8, 3, 8, 8, 3, 8, 8, 3, 8, 8, 3, 8, 8, 3, 8, 8, 3, 8, 8, 3, 8, 8, 3, 8, 8, 3, 8, 8, 3, 8, 8, 3, 8, 8, 3, 8, 8, 3, 8, 8, 3, 8, 8, 3, 8, 8, 3, 8, 8, 3, 8, 8, 3, 8, 8, 3, 8, 8, 3, 8, 8, 3, 8, 8, 3, 8, 8, 3, 8, 8, 3, 8, 8, 3, 8, 8, 3, 8, 8, 3, 8, 8, 3, 8, 8, 3, 8, 8, 3, 8, 8, 3, 8, 8,3],
			 [ 3, 8, 8, 3, 8, 8, 3, 8, 8, 3, 8, 8, 3, 8, 8, 3, 8, 8, 3, 8, 8, 3, 8, 8, 3, 8, 8, 3, 8, 8, 3, 8, 8, 3, 8, 8, 3, 8, 8, 3, 8, 8, 3, 8, 8, 3, 8, 8, 3, 8, 8, 3, 8, 8, 3, 8, 8, 3, 8, 8, 3, 8, 8, 3, 8, 8, 3, 8, 8, 3, 8, 8, 3, 8, 8, 3, 8, 8, 3, 8, 8, 3, 8, 8, 3, 8, 8, 3, 8, 8, 3, 8, 8, 3, 8, 8, 3, 8, 8,3],
			 [ 3, 3, 3, 3, 3, 3, 3, 3, 3, 3, 3, 3, 3, 3, 3, 3, 3, 3, 3, 3, 3, 3, 3, 3, 3, 3, 3, 3, 3, 3, 3, 3, 3, 3, 8, 3, 3, 3, 3, 3, 3, 3, 3, 3, 3, 3, 3, 3, 3, 3, 3, 3, 3, 3, 3, 3, 3, 3, 3, 3, 3, 3, 3, 3, 3, 8, 3, 3, 3, 3, 3, 3, 3, 3, 3, 3, 3, 3, 3, 3, 3, 3, 3, 3, 3, 3, 3, 3, 3, 3, 3, 3, 3, 3, 3, 3, 3, 3, 3,3],
			 [ 3, 8, 8, 3, 8, 8, 3, 8, 8, 3, 8, 8, 3, 8, 8, 3, 8, 8, 3, 8, 8, 3, 8, 8, 3, 8, 8, 3, 8, 8, 3, 8, 8, 3, 8, 8, 3, 8, 8, 3, 8, 8, 3, 8, 8, 3, 8, 8, 3, 8, 8, 3, 8, 8, 3, 8, 8, 3, 8, 8, 3, 8, 8, 3, 8, 8, 3, 8, 8, 3, 8, 8, 3, 8, 8, 3, 8, 8, 3, 8, 8, 3, 8, 8, 3, 8, 8, 3, 8, 8, 3, 8, 8, 3, 8, 8, 3, 8, 8,3],
			 [ 3, 8, 8, 3, 8, 8, 3, 8, 8, 3, 8, 8, 3, 8, 8, 3, 8, 8, 3, 8, 8, 3, 8, 8, 3, 8, 8, 3, 8, 8, 3, 8, 8, 3, 8, 8, 3, 8, 8, 3, 8, 8, 3, 8, 8, 3, 8, 8, 3, 8, 8, 3, 8, 8, 3, 8, 8, 3, 8, 8, 3, 8, 8, 3, 8, 8, 3, 8, 8, 3, 8, 8, 3, 8, 8, 3, 8, 8, 3, 8, 8, 3, 8, 8, 3, 8, 8, 3, 8, 8, 3, 8, 8, 3, 8, 8, 3, 8, 8,3],
			 [ 3, 3, 3, 3, 3, 3, 3, 3, 3, 3, 3, 3, 3, 3, 3, 3, 3, 3, 3, 3, 3, 3, 3, 3, 3, 3, 3, 3, 3, 3, 3, 3, 3, 3, 8, 3, 3, 3, 3, 3, 3, 3, 3, 3, 3, 3, 3, 3, 3, 3, 3, 3, 3, 3, 3, 3, 3, 3, 3, 3, 3, 3, 3, 3, 3, 8, 3, 3, 3, 3, 3, 3, 3, 3, 3, 3, 3, 3, 3, 3, 3, 3, 3, 3, 3, 3, 3, 3, 3, 3, 3, 3, 3, 3, 3, 3, 8, 8, 8,8],
			 [ 3, 8, 8, 3, 8, 8, 3, 8, 8, 3, 8, 8, 3, 8, 8, 3, 8, 8, 3, 8, 8, 3, 8, 8, 3, 8, 8, 3, 8, 8, 3, 8, 8, 3, 8, 8, 3, 8, 8, 8, 8, 8, 3, 8, 8, 3, 8, 8, 3, 8, 8, 3, 8, 8, 3, 8, 8, 3, 8, 8, 3, 8, 8, 3, 8, 8, 3, 8, 8, 8, 8, 8, 3, 8, 8, 3, 8, 8, 3, 8, 8, 3, 8, 8, 3, 8, 8, 3, 8, 8, 3, 8, 8, 3, 8, 8, 8, 8, 8,8],
			 [ 3, 8, 8, 3, 8, 8, 3, 8, 8, 3, 8, 8, 3, 8, 8, 3, 8, 8, 3, 8, 8, 3, 8, 8, 3, 8, 8, 3, 8, 8, 3, 8, 8, 3, 8, 8, 3, 8, 8, 3, 8, 8, 8, 8, 8, 8, 8, 8, 8, 8, 8, 8, 8, 8, 8, 8, 8, 8, 8, 8, 8, 8, 8, 8, 8, 8, 8, 8, 8, 3, 8, 8, 8, 8, 8, 8, 8, 8, 8, 8, 8, 3, 8, 8, 3, 8, 8, 3, 8, 8, 3, 8, 8, 3, 8, 8, 8, 8, 8,8],
			 [ 3, 3, 3, 3, 3, 3, 3, 3, 3, 3, 3, 3, 3, 3, 3, 3, 3, 3, 3, 3, 3, 3, 3, 3, 3, 3, 3, 3, 3, 3, 3, 3, 3, 3, 8, 8, 8, 8, 3, 3, 3, 3, 3, 3, 3, 3, 3, 3, 3, 3, 3, 3, 3, 3, 3, 3, 3, 3, 3, 3, 3, 3, 3, 3, 3, 3, 3, 3, 3, 3, 3, 3, 3, 3, 3, 3, 3, 3, 3, 3, 8, 8, 8, 8, 8, 8, 8, 8, 8, 8, 8, 8, 8, 8, 8, 3, 8, 8, 8,8]
			 ],
	"adjacency": [null,null,null,null],
	"tileType": {"walk": [0,1,6,7, 8,9,10,11,15,16,17,21,22,23,45,47]},
	"entities":
	[
	  {"type": "Entity",
			"sprite": "wightkey",
			"position": {"x": 99, "y": 42},
			"dimensions": {"width": 1, "height": 1},
			"animation": [false, "none", true, true],
			"onUse": "function talk(user) {this.output.setMessage([\"'You find the great white key:\",\"you pick it up and put it you pocket'\",\"Press the spacebar to continue...'\"]); PC.prototype.getKey(this);}"
	  }
	],
	"warps":
	{
		"forestZone-subway": {"row": 18, "column":  3, "targetMap": "subway1", "targetWarp": "subway-forestZone"}
	}
}