{
	"tileset": "tiles",
	"grid": [[31,31,31,31,31,31,31,31,31,31,31,31,31,31,31,31,31,31],
			 [37,37,37,37,37,37,37,37,37,37,37,37,37,37,37,37,37,37],	
			 [45,45,45,45,45,45,45,45,45,45,45,45,45,45,45,45,45,45],
			 [45,45,45,45,45,45,45,45,45,45,45,45,45,45,45,45,45,45],
			 [45,45,45,45,45,45,45,45,45,45,45,45,45,45,45,45,45,45],
			 [45,45,45,45,45,45,45,45,45,45,45,45,45,45,45,45,45,45],
			 [13,13,13,13,13,13,13,13,13,13,13,13,13,13,13,13,13,13],
			 [25,25,25,25,25,25,25,25,25,25,25,25,25,25,25,25,25,25]],
	"adjacency": [null, null, "subway1", "subway1"],
	"tileType": {"walk": [0,1,6,7,8,9,10,11,15,16,17,21,22,23,45,47]}
}