{
	"tileset": "tiles",
	"grid": [[3,3,3,3,3,3,3,3,3,3,3,3,3,3,3,3,3,3,3,3,3,3,3,3,3,3,3,3,3,3],
			 [3,3,3,3,3,3,3,3,3,3,3,3,3,3,3,3,3,3,3,3,3,3,3,3,3,3,3,3,3,3],
			 [3,3,3,3,3,3,3,3,3,3,3,3,3,3,3,3,3,3,3,3,3,3,3,3,3,3,3,3,3,3],
			 [3,3,3,3,3,3,3,3,3,3,3,3,3,3,3,3,3,3,3,3,3,3,3,3,3,3,3,3,3,3],
			 [3,3,3,3,3,3,3,3,3,3,3,3,3,3,3,3,3,3,3,3,3,3,3,3,3,3,3,3,3,3],
			 [3,3,3,3,3,3,3,3,3,3, 3, 3, 0,23, 8, 8, 8, 8, 8,15,3,3,3,3,3,3,3,3,3,3],
			 [3,3,3,3,3,3,3,3,3,3, 22,22,23, 8, 8, 8, 8, 8, 8,21, 3,3,3,3,3,3,3,3,3,3],
			 [3,3,3,3,3,3,3,3,3,3, 8, 9,10,10,10,10,10,11, 8, 8, 3,3,3,3,3,3,3,3,3,3],
			 [3,3,3,3,3,3,3,3,3,3, 8,15,16,12,13,13,14,17, 8, 8, 3,3,3,3,3,3,3,3,3,3],
			 [3,3,3,3,3,3,3,3,3,3, 8,15,16,24,25,25,26,17, 8, 8, 3,3,3,3,3,3,3,3,3,3],
			 [3,3,3,3,3,3,3,3,3,3, 8,15,16,30,32,34,35, 6,10,10, 3,3,3,3,3,3,3,3,3,3],
			 [3,3,3,3,3,3,3,3,3,3, 8,15,16,36,42,43,41, 2, 2, 2, 3,3,3,3,3,3,3,3,3,3],
			 [3,3,3,3,3,3,3,3,3,3, 8,21,22,22, 8,22,22,22,22,22, 3,3,3,3,3,3,3,3,3,3],
			 [3,3,3,3,3,3,3,3,3,3, 9,10,10,11, 8, 8, 8, 8, 8, 8, 3,3,3,3,3,3,3,3,3,3],
			 [3,3,3,3,3,3,3,3,3,3, 7, 3, 3,17, 8, 8, 8, 8, 8, 9, 3,3,3,3,3,3,3,3,3,3],
			 [3,3,3,3,3,3,3,3,3,3,3,3,3,3,3,3,3,3,3,3,3,3,3,3,3,3,3,3,3,3],
			 [3,3,3,3,3,3,3,3,3,3,3,3,3,3,3,3,3,3,3,3,3,3,3,3,3,3,3,3,3,3],
			 [3,3,3,3,3,3,3,3,3,3,3,3,3,3,3,3,3,3,3,3,3,3,3,3,3,3,3,3,3,3],
			 [3,3,3,3,3,3,3,3,3,3,3,3,3,3,3,3,3,3,3,3,3,3,3,3,3,3,3,3,3,3],
			 [3,3,3,3,3,3,3,3,3,3,3,3,3,3,3,3,3,3,3,3,3,3,3,3,3,3,3,3,3,3]],
	"adjacency": [null, null, null, null],
	"entities":
	[
		{
			"type": "Entity",
			"sprite": "blu",
			"position": {"x": 11, "y": 11},
			"dimensions": {"width": 1, "height": 2},
			"animation": [false, "walk-right", false, true],
			"onUse": "function look() {this.output.setMessage([\"It's a statue!\",\"\",\"The plaque reads:\",\"'In tribute to our founding overloard\",\"Big Blu.'\"]);}"
		},
		{
			"type": "Entity",
			"sprite": "blu",
			"position": {"x": 13, "y": 12},
			"dimensions": {"width": 1, "height": 1},
			"animation": [true, "walk-left", true, true],
			"onUse": "function talk(user) {this.move(user.facing,'walk');}"
		},
		{
			"type": "Entity",
			"sprite": "clear",
			"position": {"x": 15, "y": 16},
			"dimensions": {"width": 1, "height": 1},
			"onUse": "function look() {this.output.setMessage([\"'Notice to the thief:\",\"Please return our equipment!'\"]);}"
		}
	],
	"tileType": {"walk": [0,1,6,7,8,9,10,11,15,16,17,21,22,23,42,45,47]},
	"warps":
	{
		"zone1-subway": {"row": 11, "column": 14, "targetMap": "subway1", "targetWarp": "subway-zone1"}
	}
}